time(s),question,response,input_Tokens,output_Tokens,Total_Tokens
3.827165365219116,¿Por qué se considera fundamental el estudio del Procesamiento del Lenguaje Natural en la interacción entre humanos y máquinas?,"Se considera fundamental el estudio del Procesamiento del Lenguaje Natural (PLN) en la interacción entre humanos y máquinas porque permite que las máquinas realicen tareas que involucran el lenguaje humano, facilitando así la comunicación efectiva entre ambos. El PLN abarca el análisis sintáctico y semántico de las palabras y frases, lo que permite a las máquinas comprender y procesar mejor el lenguaje. También ayuda en la mejora de la comunicación entre humanos y máquinas al habilitar a las máquinas con habilidades de comunicación más sofisticadas, lo que es crucial para aplicaciones como los agentes conversacionales, los sistemas de búsqueda de respuestas y la traducción automática (Archivo: 1-Tema.pdf, Página 6 y Página 7).",3143,148,3291
4.162233829498291,¿De qué manera el PLN mejora la experiencia del usuario en aplicaciones cotidianas?,"El Procesamiento del Lenguaje Natural (PLN) mejora la experiencia del usuario en aplicaciones cotidianas al permitir una mejor interacción entre los usuarios y las máquinas. Esto se traduce en aplicaciones como chatbots que pueden comprender y responder a preguntas en lenguaje natural, asistentes virtuales que gestionan tareas, y sistemas de recomendación que analizan las preferencias del usuario. Además, en el ámbito de Recursos Humanos, por ejemplo, el PLN ayuda a filtrar currículums de forma eficiente, alineando candidatos con las características del puesto deseado, lo que facilita el proceso de selección (Archivo: 1-Tema.pdf, Página 12).  En general, las aplicaciones de PLN permiten a los usuarios realizar consultas de manera más intuitiva, acceder a información relevante sin esfuerzo y recibir respuestas más precisas, mejorando así la usabilidad y satisfacción general con las aplicaciones (Archivo: 1-Tema.pdf, Página 8).",534,188,722
3.1199533939361572,¿Qué papel juega la tokenización en el análisis de textos?,"La tokenización juega un papel crucial en el análisis de textos al dividir el contenido textual en unidades manejables llamadas ""tokens"", que pueden ser palabras, frases o incluso caracteres. Este proceso es fundamental para cualquier tipo de procesamiento de lenguaje natural (PLN), ya que permite a los algoritmos analizar y comprender la estructura y el significado de un texto. Sin la tokenización, el análisis se volvería extremadamente complejo, ya que los modelos no podrían identificar y trabajar con las partes constitutivas de un texto de manera eficaz.  Aunque el contexto proporcionado no menciona específicamente la tokenización, se puede inferir que es un paso preliminar esencial antes de aplicar otros métodos, como el etiquetado morfosintáctico o el análisis semántico, mencionados en la descripción general del campo del PLN (Archivo: 1-Tema.pdf, Página 23).",2050,176,2226
3.429164409637451,¿Por qué es importante contar con un corpus de calidad en el desarrollo de modelos de PLN?,"Contar con un corpus de calidad en el desarrollo de modelos de Procesamiento del Lenguaje Natural (PLN) es fundamental por varias razones. Primero, un corpus bien anotado promueve la tendencia de abordar problemas complejos del PLN, como el análisis sintáctico y semántico, utilizando métodos de aprendizaje automático supervisado. Este tipo de corpus permite aplicar algoritmos más avanzados y evaluar los modelos de manera efectiva, ya que proporciona datos etiquetados que son esenciales para el entrenamiento de los modelos (Archivo: 1-Tema.pdf, Página 23).  Además, el coste y la dificultad de producir corpus anotados puede convertirse en un factor limitante para el uso de enfoques supervisados en muchos problemas del PLN. Por lo tanto, un corpus de calidad ayuda a facilitar el uso de técnicas de aprendizaje automático y a mejorar la eficacia de las aplicaciones lingüísticas del PLN (Archivo: 1-Tema.pdf, Página 23).",1902,192,2094
7.039716958999634,¿Cuál es la diferencia fundamental entre stemming y lematización?,"La diferencia fundamental entre stemming y lematización radica en cómo abordan la reducción de palabras a su forma raíz.   - **Stemming** se refiere al proceso de eliminar los sufijos de las palabras para reducirlas a su raíz, que puede no ser necesariamente una palabra válida en el idioma. Es un método más agresivo y menos preciso, ya que puede cortar palabras de manera indiscriminada.  - **Lematización**, por otro lado, implica reducir las palabras a su forma base o lema, considerando su contexto y significado gramatical. Esto significa que la lematización produce una palabra válida que se encuentra en el diccionario, lo cual requiere un análisis más profundo del lenguaje y sus estructuras.  Ambos métodos se utilizan en el procesamiento del lenguaje natural, pero la lematización tiende a ser más precisa y contextualizada que el stemming.   Este resumen de la diferencia entre stemming y lematización no se encuentra en el contexto proporcionado, y se basa en un conocimiento general sobre el procesamiento de lenguaje natural.",1822,210,2032
2.2991976737976074,¿Cómo se relaciona el análisis sintáctico con la comprensión del lenguaje?,"El análisis sintáctico se relaciona de manera fundamental con la comprensión del lenguaje, ya que permite identificar las relaciones estructurales entre palabras y cómo estas se agrupan para formar oraciones coherentes. Un agente conversacional necesita saber que una secuencia de palabras, aunque contenga términos válidos, puede carecer de sentido si no está ordenada correctamente. Por lo tanto, el conocimiento sintáctico es crucial para que el agente pueda encadenar las palabras adecuadamente en su respuesta, garantizando que la oración resultante sea gramaticalmente correcta y comprensible.  Esta información se extrae del texto ""Ideas clave sobre el procesamiento del lenguaje natural"" en la página 29 del documento.",3700,143,3843
2.9092068672180176,¿Qué se entiende por “modelo de lenguaje” y para qué se utiliza?,"En el contexto del procesamiento del lenguaje natural, un ""modelo de lenguaje"" se refiere a una representación computacional que se utiliza para predecir la probabilidad de ocurrencia de una secuencia de palabras en un lenguaje. Estos modelos son fundamentales para diversas aplicaciones de procesamiento del lenguaje, como la traducción automática, el análisis de sentimientos, el reconocimiento de voz y la generación de texto.  El uso de ""modelos de lenguaje"" permite a las máquinas comprender el contexto y la gramática de las oraciones, lo que facilita una interacción más natural entre humanos y computadoras. Son una herramienta esencial en el desarrollo de sistemas de inteligencia artificial que operan con lenguaje humano.  Esta información se puede extraer de la sección sobre ""Procesamiento del Lenguaje Natural"" (pág. 6) y ""Historia del procesamiento del lenguaje natural"" (pág. 13) en el documento proporcionado.",3197,183,3380
2.1980886459350586,¿Por qué es relevante el análisis de sentimiento en el procesamiento de opiniones y reseñas?,"No hay contexto proporcionado en la sección dada, por lo que no puedo citar ni responder específicamente a la pregunta. Sin embargo, puedo explicar que el análisis de sentimiento es relevante en el procesamiento de opiniones y reseñas porque permite identificar y extraer las emociones y opiniones subyacentes en el texto, lo que ayuda a las empresas a comprender mejor las percepciones de los consumidores sobre sus productos o servicios. Esto puede guiar decisiones estratégicas, mejorar el servicio al cliente y adaptar las ofertas a las necesidades y deseos del mercado.",128,108,236
2.770530939102173,¿En qué consiste el proceso de normalización del texto y por qué se aplica?,"El proceso de normalización del texto consiste en preparar el texto para su análisis mediante la reducción de variaciones no esenciales, asegurando una forma homogénea de los datos. Esto puede incluir convertir todo el texto a minúsculas, eliminar caracteres especiales, corregir errores tipográficos y estandarizar la gramática y el uso de palabras. Se aplica para facilitar el análisis lingüístico y mejorar la precisión de las tareas posteriores, como la extracción de información, análisis de sentimientos o clasificación de texto.  Aunque el contexto proporcionado no describe específicamente el proceso de normalización del texto, es un concepto fundamental en el procesamiento del lenguaje natural (PLN) que permite optimizar el rendimiento de los algoritmos utilizados en esta área.",1183,146,1329
9.355230808258057,¿Qué ventajas ofrece el uso de algoritmos de clasificación en el PLN?,"El uso de algoritmos de clasificación en el procesamiento del lenguaje natural (PLN) ofrece varias ventajas. Una de ellas es la capacidad de abordar problemas complejos de análisis sintáctico y semántico mediante enfoques de aprendizaje automático supervisado, lo cual permite una mejor comprensión y estructuración de los datos lingüísticos. Esto se ha visto facilitado por la adopción de técnicas como máquinas de vectores de soporte (SVM) y modelos bayesianos, entre otros, lo que ha llevado a una interacción más efectiva entre lingüistas computacionales y la comunidad estadística (Archivo: 1-Tema.pdf, página 23).  Además, los algoritmos pueden ser especialmente útiles en aplicaciones prácticas, como en el ámbito de Recursos Humanos para la criba curricular, donde pueden clasificar y ordenar grandes volúmenes de currículums de acuerdo con la alineación de los mismos con las descripciones de los puestos de trabajo (Archivo: 1-Tema.pdf, página 12). Estos algoritmos ayudan a procesar textos para extraer información relevante de manera eficiente, lo que es fundamental en contextos donde el volumen de datos es elevado y el análisis manual resulta laborioso (Archivo: 1-Tema.pdf, página 12).",973,252,1225
3.820554733276367,¿Cómo se utiliza el etiquetado POS (Part-of-Speech) en el procesamiento de textos?,"El contexto proporcionado no menciona explícitamente el etiquetado POS (Part-of-Speech) ni cómo se utiliza en el procesamiento de textos. Sin embargo, se puede inferir que el conocimiento del lenguaje, que es fundamental en el procesamiento de lenguaje natural (PLN), incluye técnicas como el etiquetado POS para identificar la función de las palabras en un texto. Este tipo de etiquetado permite a los sistemas de PLN entender mejor el significado de las oraciones al clasificar las palabras en categorías como sustantivos, verbos, adjectivos, etc., lo cual es crucial para aplicaciones más complejas como los agentes conversacionales y los sistemas de traducción automática.  Si necesitas información específica sobre el etiquetado POS, no dudes en preguntar.",412,154,566
5.4983971118927,¿Qué desafíos presenta la ambigüedad lingüística en la interpretación de textos?,"La ambigüedad lingüística presenta varios desafíos en la interpretación de textos, entre los cuales se incluyen:  1. **Resolución de referencias**: La ambigüedad puede dificultar la identificación clara de a qué o a quién se refiere un pronombre o una expresión en particular. Esto se relaciona con el trabajo de Hobbs (1978) en el que se discute cómo resolver las referencias de pronombres en el discurso.  2. **Coherencia y correferencias**: La ambigüedad también puede afectar la coherencia del texto, ya que diferentes interpretaciones pueden llevar a confusiones sobre la conexión entre ideas y elementos del discurso. Hobbs (1979) examina cómo la coherencia está vinculada a la correferencia, haciendo hincapié en que la falta de claridad en las referencias puede llevar a malentendidos.  3. **Interpretación de roles semánticos**: La ambigüedad en la estructura de las oraciones puede dificultar la identificación de los roles semánticos de los participantes en un evento, lo que complica la tarea de entender las relaciones entre sujetos y objetos en un texto. Lang y Lapata (2014) abordan este problema a través de la inducción",649,256,905
2.4229259490966797,¿Cómo contribuyen las redes neuronales al avance en el PLN?,"Las redes neuronales han contribuido significativamente al avance en el procesamiento del lenguaje natural (PLN) a través del uso del aprendizaje profundo. Este enfoque se ha popularizado desde que Geoffrey Hinton acuñó el término ""deep learning"" en 2006. En la década de 2010, las redes neuronales profundas empezaron a aplicarse en distintos ámbitos del PLN, especialmente en tareas como el análisis morfosintáctico y el análisis sintáctico, donde se han utilizado redes neuronales recurrentes como alternativa a los modelos ocultos de Markov. Además, el ""deep learning"" es la base de los modelos de secuencia a secuencia (seq2seq) que se emplean en agentes conversacionales y chatbots actuales (Archivo: 1-Tema.pdf, Página 24).",2442,165,2607
3.0341384410858154,¿Qué es la generación de lenguaje natural (NLG) y cuál es su aplicación práctica?,"La generación de lenguaje natural (NLG) es un subcampo del procesamiento del lenguaje natural (PLN) que se centra en la creación de texto en lenguaje humano a partir de datos estructurados. La NLG permite a las máquinas producir texto que puede ser entendido y utilizado por personas, facilitando la comunicación entre humanos y computadoras.  Una aplicación práctica de la NLG se encuentra en la creación de informes automáticos basados en datos, donde se generan descripciones en lenguaje natural que resumen los hallazgos de conjuntos de datos, como en el análisis de encuestas o reportes financieros. También es utilizada en chatbots y agentes conversacionales, donde se requiere que la máquina responda a preguntas o realice interacciones en lenguaje natural con los usuarios.  Esta información resalta el papel fundamental que juega la NLG dentro del PLN y cómo se aplica en situaciones del mundo real.   **Referencia:** Archivo: 1-Tema.pdf (Página 6)",2844,195,3039
2.5955803394317627,¿De qué manera la segmentación de oraciones facilita el análisis textual?,"La segmentación de oraciones facilita el análisis textual al permitir que se organicen las estructuras lingüísticas de manera más clara y comprensible. A través de la segmentación, se identifican las oraciones individuales dentro de un texto, lo que ayuda en la identificación de relaciones sintácticas y semánticas. Esto es esencial para el procesamiento del lenguaje natural, ya que permite aplicar algoritmos que analizan el contenido y la estructura del texto de forma más eficiente. Además, la segmentación puede servir de base para tareas avanzadas como el etiquetado morfosintáctico y semántico, que son cruciales para tareas automatizadas como la traducción y el modelado de temas, tal como se indica en el archivo mencionado (1-Tema.pdf, Página 23).",566,160,726
2.243539333343506,¿Qué importancia tiene la detección de entidades en el PLN?,"La detección de entidades en el procesamiento del lenguaje natural (PLN) es crucial porque permite identificar y clasificar automáticamente palabras o frases en categorías predefinidas, como nombres de personas, organizaciones, lugares, fechas, entre otros. Esto es fundamental para extraer información relevante de grandes volúmenes de texto y para mejorar la interacción entre humanos y computadoras a través de aplicaciones como la recuperación de información, la traducción automática y la generación de lenguaje natural. Además, ayuda en tareas prácticas como la criba curricular en Recursos Humanos, donde se puede alinear los currículos con descripciones de puestos de trabajo.  Esto se evidencia en la sección que informa sobre las aplicaciones del PLN, donde se menciona cómo técnicas de PLN permiten procesar textos y extraer la información relevante contenida en ellos (Archivo: 1-Tema.pdf, Página 12).",1357,175,1532
3.3481621742248535,¿Cómo se puede utilizar el PLN en el área de la atención al cliente?,"El procesamiento del lenguaje natural (PLN) se puede utilizar en el área de la atención al cliente de diversas maneras, como por ejemplo:  1. **Chatbots y asistentes virtuales**: Estas herramientas permiten interactuar con los clientes de manera automatizada, respondiendo preguntas frecuentes y resolviendo problemas sin la necesidad de intervención humana inmediata. Esto optimiza el tiempo de respuesta y mejora la experiencia del cliente.  2. **Análisis de sentimientos**: El PLN puede analizar la comunicación de los clientes en redes sociales, correos electrónicos o encuestas para identificar sentimientos y emociones. Esto ayuda a las empresas a entender mejor la percepción de su servicio y a realizar ajustes según sea necesario.  3. **Clasificación y priorización de consultas**: Las técnicas de PLN pueden automatizar la clasificación de las solicitudes de los clientes, permitiendo que las consultas más urgentes se manejen primero y aumentando así la eficiencia del servicio al cliente.  4. **Extracción de información**: El PLN puede utilizarse para procesar grandes volúmenes de textos, como encuestas de satisfacción o chats, y extraer información relevante, permitiendo a las empresas conocer puntos de mejora en su servicio.   Estas aplicaciones del PLN son clave para optimizar la atención al cliente, mejorando",1137,256,1393
2.720468044281006,¿Qué es el análisis de dependencias y cómo ayuda en la comprensión de una oración?,"El análisis de dependencias es una técnica utilizada en el procesamiento del lenguaje natural que se centra en la relación gramatical entre las palabras de una oración. En este tipo de análisis, se considera cómo las palabras dependen unas de otras para formar significados completos, identificando cuál es el núcleo (generalmente un verbo) y cómo se relacionan los diferentes complementos y modificadores con este núcleo.  Este enfoque ayuda en la comprensión de una oración al descomponerla en sus componentes fundamentales y establecer una estructura jerárquica que muestra cómo las palabras se conectan entre sí. Al entender estas relaciones, los sistemas de procesamiento del lenguaje pueden interpretar correctamente el significado de las oraciones, facilitando tareas como el análisis sintáctico y semántico, la traducción automática y la generación de lenguaje natural.  (Información extraída de ""Procesamiento del Lenguaje Natural"", Página 21)",1642,182,1824
2.2956767082214355,¿En qué consiste el aprendizaje supervisado en el contexto del PLN?,"El aprendizaje supervisado en el contexto del procesamiento del lenguaje natural (PLN) consiste en utilizar conjuntos de datos que están anotados con información específica para enseñar a los modelos a realizar tareas como el análisis sintáctico y semántico. Durante este proceso, el modelo aprende a identificar patrones a partir de ejemplos previamente etiquetados, lo que le permite hacer predicciones o clasificaciones sobre nuevos datos. Esta metodología se volvió estándar en el PLN a medida que se desarrollaron recursos anotados como el Penn Treebank y el PropBank, que contienen información sobre la estructura de las dependencias y anotaciones semánticas, respectivamente (Archivo: 1-Tema.pdf, Página 23).",3004,140,3144
3.5090723037719727,¿Qué papel juega el preprocesamiento en el rendimiento de un modelo de PLN?,"El preprocesamiento juega un papel crucial en el rendimiento de un modelo de Procesamiento del Lenguaje Natural (PLN) al facilitar la preparación de los datos de texto de manera que sean más comprensibles para los algoritmos de aprendizaje automático. Esto incluye actividades como la normalización del texto, el etiquetado de partes del discurso y la eliminación de ruido o datos irrelevantes. Al realizar estas tareas, se mejora la calidad de los datos de entrada, lo que puede llevar a mejores resultados en análisis posteriores, como la clasificación, traducción automática o etiquetado semántico. Un preprocesamiento adecuado asegura que el modelo tenga acceso a información relevante y bien estructurada, aumentando así su eficacia en las tareas de PLN (Archivo: 1-Tema.pdf, Página 27).",1720,162,1882
2.0236093997955322,¿Cómo se aplica el PLN en sistemas de traducción automática?,"En los sistemas de traducción automática, el objetivo es traducir automáticamente un documento de un idioma a otro, no solo en textos escritos, sino también en la traducción del habla. Se utilizan métodos estadísticos basados en frases para obtener los mejores resultados, lo que implica el uso de aprendizaje automático para analizar grandes conjuntos de datos y realizar traducciones que no siempre consideran cuestiones gramaticales. Además, se requieren herramientas para resolver la ambigüedad de las palabras, como los algoritmos de desambiguación (Título: ""Aplicaciones del PLN"", Página 10).",2414,118,2532
2.8433048725128174,¿Por qué es necesario actualizar y mejorar constantemente los corpus utilizados en el PLN?,"Es necesario actualizar y mejorar constantemente los corpus utilizados en el procesamiento del lenguaje natural (PLN) debido a que el coste y la dificultad de producir corpus anotados se convirtió en un factor limitante para el uso de enfoques supervisados en muchos problemas del PLN. Esto hizo que, a partir de 2005, surgiera una nueva tendencia hacia el uso de técnicas de aprendizaje no supervisado, que permitieron construir aplicaciones lingüísticas a partir de datos sin anotación. Además, el aumento en la velocidad y memoria de los ordenadores, así como la necesidad de responder a problemas más complejos, resaltan la importancia de mantener los corpus actualizados para desarrollar modelos más eficaces y adaptados a las situaciones actuales. Este enfoque se ha utilizado en diversas aplicaciones del PLN, como el etiquetado morfosintáctico y semántico (Página 23, ""Procesamiento del Lenguaje Natural"").",1589,184,1773
4.817375898361206,¿Qué retos presenta el manejo de lenguaje coloquial o regional en el PLN?,"El contexto proporcionado no menciona directamente los retos específicos del manejo del lenguaje coloquial o regional en el procesamiento del lenguaje natural (PLN). Sin embargo, se puede inferir que el PLN enfrenta desafíos relacionados con la variabilidad en el uso del lenguaje, como la jerga, los modismos y las diferencias dialectales que pueden complicar la precisión en el análisis y procesamiento de texto.  El manejo de dialectos o lenguajes coloquiales presenta varias dificultades, como:  1. **Ambigüedad**: El lenguaje coloquial a menudo contiene términos que tienen significados diferentes dependiendo del contexto regional, lo que puede generar ambigüedad para los sistemas de PLN.  2. **Variación léxica**: Existen diferencias en la elección de palabras entre regiones, lo que significa que un mismo concepto puede ser expresado de diferentes maneras.  3. **Estructura gramatical**: El uso no estándar de la gramática en el lenguaje coloquial puede causar problemas en el análisis sintáctico y semántico.  4. **Falta de recursos anotados**: La escasez de corpus anotados que reflejen el lenguaje coloquial limita la capacidad de entrenar modelos de PLN eficaces.  Los retos del manejo de lenguaje",2627,256,2883
2.4709343910217285,¿Cómo influye el tamaño del corpus en la capacidad de un modelo de PLN?,"El tamaño del corpus influye en la capacidad de un modelo de Procesamiento del Lenguaje Natural (PLN) al determinar la cantidad de datos disponibles para su entrenamiento y para el análisis. Un corpus más grande permite al modelo aprender patrones lingüísticos y contextuales más complejos, mejorando su precisión y eficacia en tareas específicas. Sin embargo, si el número de textos es muy elevado, puede resultar laborioso analizar manualmente toda esa información, lo que justifica el uso de técnicas de PLN para procesar estos textos y extraer información relevante (Archivo: 1-Tema.pdf, Página 12).",403,123,526
2.928743600845337,¿Qué beneficios se obtienen al integrar técnicas de PLN en sistemas educativos?,"La integración de técnicas de procesador del lenguaje natural (PLN) en sistemas educativos ofrece varios beneficios, entre los cuales se destacan:  1. **Mejora en la gestión del contenido educativo**: Las técnicas de PLN pueden ayudar a organizar y categorizar el material didáctico, facilitando su acceso y uso por parte de estudiantes y docentes.  2. **Análisis y retroalimentación automatizada**: El PLN permite analizar automáticamente las respuestas de los estudiantes y proporcionar retroalimentación personalizada, lo que puede mejorar el proceso de aprendizaje.  3. **Soporte en la enseñanza de lenguas**: Los sistemas de PLN pueden ser utilizados para desarrollar aplicaciones que ayuden en la enseñanza de gramática, vocabulario y pronunciación, ofreciendo prácticas personalizadas a los estudiantes.  4. **Facilitación del aprendizaje adaptativo**: Al analizar el rendimiento y las necesidades de los estudiantes, el PLN puede contribuir a crear experiencias de aprendizaje más adaptativas, ajustando el contenido y la dificultad de las actividades en función de cada individuo.  Estos beneficios se derivan de la capacidad del PLN de procesar y analizar el lenguaje de manera efectiva, lo que enriquece la experiencia educativa y optimiza el aprendizaje de los estudiantes.",1437,248,1685
4.413072109222412,¿Cómo influye el proceso de preprocesamiento en la calidad del análisis de textos en PLN?,"El proceso de preprocesamiento es fundamental en el análisis de textos en el procesamiento del lenguaje natural (PLN), ya que permite mejorar la calidad de los datos que se utilizarán para el análisis. El preprocesamiento incluye etapas como la tokenización, la eliminación de stop words, la normalización y el etiquetado, las cuales preparan el texto crudo para ser interpretado adecuadamente por los algoritmos de aprendizaje automático.  Una buena calidad en la preparación de los datos puede influir directamente en la precisión y relevancia de los resultados del análisis, ya que permite que los modelos aprendan características importantes del lenguaje en lugar de ruido o inconsistencias presentes en el texto original. Por tanto, un preprocesamiento adecuado puede mejorar significativamente la capacidad de los modelos para realizar tareas como análisis semántico y sintáctico.  Para ilustrar esto, se menciona que ""el coste y la dificultad de producir corpus anotados se convirtió en un factor limitante del uso de los enfoques supervisados para muchos problemas del procesamiento del lenguaje"" (Archivo: 1-Tema.pdf, Página 23). Esto subraya la importancia de manejar los datos de manera efectiva desde la etapa de preprocesamiento, ya que la calidad de los corpus influye en los análisis",2500,256,2756
3.3546550273895264,¿Qué implicaciones tiene el uso de técnicas de embeddings en comparación con representaciones tradicionales como bag-of-words?,"El uso de técnicas de embeddings en procesamiento del lenguaje natural tiene varias implicaciones en comparación con representaciones tradicionales como bag-of-words. Las técnicas de embeddings, como word2vec o GloVe, representan palabras en un espacio vectorial continuo, lo que permite capturar relaciones semánticas y contextuales más complejas. Esto significa que palabras con significados similares están más cerca en el espacio vectorial, facilitando tareas como la búsqueda de sinónimos y la comprensión de matices en el lenguaje.  Por otro lado, las representaciones tradicionales como bag-of-words tratan las palabras como vectores dispersos y no capturan la información de contexto o de orden. Esto limita su capacidad para entender las sutilezas del lenguaje, ya que ignoran la relación entre palabras y su disposición en el texto. Además, los embeddings permiten trabajar con datos no estructurados de manera más eficiente y efectivo, lo que es vital para tareas complejas como el análisis semántico, la traducción automática y la generación de lenguaje natural.  En resumen, la adopción de técnicas de embeddings permite un entendimiento más profundo y rico del lenguaje, superando las limitaciones inherentes a métodos más simples como bag-of-words.",1322,248,1570
5.335359811782837,¿De qué manera el mecanismo de atención en modelos como Transformers ha revolucionado la traducción automática?,"El mecanismo de atención en modelos como Transformers ha revolucionado la traducción automática al permitir que el modelo se centre de manera dinámica en las palabras relevantes de la secuencia de entrada mientras genera la salida. Esto mejora significativamente la capacidad del modelo para manejar la ambigüedad y las relaciones a largo plazo en el texto, lo que resulta en traducciones más precisas y coherentes. Los Transformers, a través de su arquitectura basada en atención, han superado las limitaciones de los enfoques anteriores, que eran menos eficaces al momento de capturar contextos complejos y dependencias en mayor distancia dentro de las oraciones.  Aunque el contexto proporcionado no menciona específicamente a los modelos de Transformers, se infiere la relevancia de los avances en procesamiento del lenguaje natural y traducción automática en general, dado el enfoque en el uso de técnicas de aprendizaje automático para abordar estos problemas complejos. Un ejemplo de sus aplicaciones es la traducción automática, donde se han alcanzado mejores resultados utilizando métodos avanzados, lo que podría incluir transformaciones digitales contemporáneas.  Esta revolución en la traducción se considera una parte importante del objetivo de la creación automática de documentos de un idioma a otro, como se menciona en ""Archivo: 1-Tema.pdf (Página ",3125,256,3381
4.823533296585083,¿Cómo se aborda el desafío de la ambigüedad semántica en el PLN mediante técnicas modernas?,"El desafío de la ambigüedad semántica en el procesamiento del lenguaje natural (PLN) se aborda mediante el uso de técnicas de aprendizaje automático, particularmente a través de métodos de aprendizaje no supervisado y algoritmos que emplean información contextual y estructuras sintácticas. Estas técnicas permiten analizar y desambiguar el significado de las palabras en función de su uso en contextos específicos.  Por ejemplo, el etiquetado semántico se ha facilitado utilizando técnicas de aprendizaje no supervisado para crear conjuntos de roles semánticos que se derivan de características sintácticas. Esto ayuda a identificar cuál es el sentido o significado apropiado de una palabra en función de su entorno dentro de una oración. Además, el enfoque de aprendizaje automático permite que los modelos se entrenen en grandes volúmenes de datos, lo que también ayuda a captar variaciones y matices de significado que pueden surgir en el uso cotidiano del lenguaje (Procesamiento del Lenguaje Natural, Tema 1, página 23).   Estas metodologías representan un avance significativo en la capacidad de los sistemas de PLN para manejar ambigüedades semánticas, al proporcionar herramientas más flexibles y adaptativas que respetan la complejidad del lenguaje humano.",3010,251,3261
5.7911999225616455,¿Qué ventajas ofrece el uso de modelos pre-entrenados en tareas específicas de PLN?,"El uso de modelos pre-entrenados en tareas específicas de procesamiento de lenguaje natural (PLN) ofrece varias ventajas significativas. Estos modelos permiten aprovechar el conocimiento ya adquirido a partir de grandes volúmenes de datos, lo que puede resultar en un mejor rendimiento en las tareas específicas sin la necesidad de entrenar modelos desde cero. Además, los modelos pre-entrenados facilitan el proceso de aprendizaje al proporcionar una base sólida sobre la cual se pueden realizar ajustes finos o ""fine-tuning"" para adaptarlos a contextos o aplicaciones particulares. Esto no solo reduce el tiempo y recursos necesarios para el desarrollo de soluciones de PLN, sino que también mejora la precisión y eficacia de las tareas específicas.  Aunque no se proporciona la cita exacta de donde proviene esta información en el contexto compartido, el enfoque en el uso de aprendizaje automático y en la importancia de los modelos pre-entrenados se encuentra implícitamente relacionado con la evolución y la mejora de los sistemas de PLN, como se describe en las páginas mencionadas.",1820,207,2027
5.156801700592041,¿Por qué es relevante la técnica de tokenización subword en el manejo de palabras desconocidas?,"La técnica de tokenización subword es relevante en el manejo de palabras desconocidas porque permite dividir las palabras en unidades más pequeñas (subwords), lo que facilita su representación y procesamiento en modelos de lenguaje. Esto es especialmente útil cuando se encuentran palabras que no han sido vistas durante el entrenamiento del modelo, ya que en lugar de ser ignoradas o tratadas de forma errónea, pueden ser descompuestas en sus componentes morfológicos. De esta manera, se garantiza que incluso palabras nuevas o raras puedan ser entendidas y manejadas con mayor efectividad, mejorando así el rendimiento del modelo en tareas de procesamiento del lenguaje natural.  La importancia de este enfoque radica en su capacidad para manejar la variabilidad del lenguaje y enriquecer la representación semántica al permitir que el modelo generalice mejor a partir de las palabras conocidas. Aunque la información específica sobre la tokenización subword no se menciona directamente en el contexto proporcionado, este tipo de técnica se ha vuelto ampliamente adoptada y relevante en el campo del procesamiento del lenguaje natural en los últimos años, especialmente con el auge de modelos de aprendizaje profundo.",2983,227,3210
4.358797311782837,¿Cómo afecta el tamaño y diversidad de un corpus a la generalización de un modelo de PLN?,"El tamaño y la diversidad de un corpus son factores fundamentales que afectan la generalización de un modelo de Procesamiento del Lenguaje Natural (PLN). Un corpus más grande y diverso permite que el modelo aprenda de una mayor variedad de ejemplos, lo que mejora su capacidad para generalizar a nuevos datos que no ha visto previamente. Esto es especialmente relevante en el contexto del uso de técnicas de aprendizaje automático, donde la variabilidad del datos puede influir en la calidad de las predicciones.  El contexto menciona que ""el coste y la dificultad de producir corpus anotados se convirtió en un factor limitante del uso de los enfoques supervisados para muchos problemas del procesamiento del lenguaje"", lo que sugiere que un corpus pobremente anotado o limitado podría llevar a modelos que no generalizan bien (Proceso del Lenguaje Natural, Página 23). Por otro lado, la tendencia hacia ""el uso de técnicas de aprendizaje no supervisado"" a partir de datos sin anotación se menciona como una forma de abordar los problemas de generalización, permitiendo la construcción de aplicaciones lingüísticas a partir de un rango más amplio de datos (Página 23).  En resumen, un corpus más grande y diverso favorece una mejor generalización en modelos de PLN al proporcionar más ejemplos y",1364,256,1620
4.192235231399536,¿Qué rol desempeña el POS tagging en la mejora del análisis semántico de un texto?,"El POS tagging (etiquetado de partes del habla) desempeña un rol crucial en la mejora del análisis semántico de un texto, ya que permite identificar la función gramatical de cada palabra en una oración. Al señalar si un sintagma es un complemento circunstancial de tiempo o un complemento del nombre, el etiquetado ayuda a entender mejor la estructura de las oraciones y los significados contextuales que emergen de ellas. Este conocimiento sintáctico se combina con el conocimiento semántico, lo que permite a los agentes conversacionales interpretar correctamente las intenciones del usuario y responder de manera adecuada.  La determinación del tipo de expresión que el usuario ha interpuesto es esencial, ya que permite al agente decidir si debe dar una respuesta hablada, realizar una acción o simplemente registrar un enunciado. Todo esto requiere el uso conjunto de la sintaxis y la semántica, al igual que del conocimiento pragmático y discursivo para manejar referencias cruzadas y reconocer la intención detrás de las interacciones del usuario. En resumen, el POS tagging mejora el análisis semántico al ofrecer una base sólida para entender la estructura y el significado de las palabras en el contexto de una conversación (Tema 1, página 29).",588,254,842
2.9398934841156006,¿Cómo se integran técnicas de machine learning supervisado en la clasificación de textos?,"Las técnicas de machine learning supervisado se integran en la clasificación de textos a través del uso de métodos estadísticos y algoritmos que requieren corpus anotados. Este enfoque permite abordar problemas complejos del procesamiento del lenguaje natural, como el análisis sintáctico y semántico, convirtiendo tareas lingüísticas en problemas de aprendizaje automático supervisado. Por ejemplo, se han aplicado máquinas de vectores de soporte (SVM), regresión logística multinomial y modelos bayesianos en la lingüística computacional para realizar clasificaciones precisas de texto.  Referencia: Procesamiento del Lenguaje Natural, Página 23.",2210,124,2334
4.1595354080200195,¿Qué desafíos presenta el manejo de lenguaje informal y cómo se pueden superar?,"El manejo del lenguaje informal presenta varios desafíos, entre los que se incluyen la variabilidad en el uso del lenguaje, la ambigüedad, y las diferencias en la gramática y el vocabulario que pueden no seguir las reglas formales. Además, el lenguaje informal a menudo incluye jerga, modismos y errores ortográficos o gramaticales, lo que complica su procesamiento.  Para superar estos desafíos, se pueden emplear varias técnicas. Una de ellas es el uso de algoritmos de aprendizaje automático, que pueden entrenarse con grandes cantidades de datos de lenguaje informal para mejorar su capacidad para reconocer patrones y contextos. Por ejemplo, las técnicas de aprendizaje no supervisado pueden ayudar a etiquetar morfosintácticamente palabras en un contexto informal, permitiendo una mejor comprensión semántica y una interpretación más precisa (Archivo: 1-Tema.pdf, Página 23).  Además, es útil adoptar enfoques híbridos que combinen reglas lingüísticas con modelos estadísticos, lo que puede ayudar a crear sistemas más robustos que sean capaces de manejar tanto el lenguaje formal como el informal (Archivo: 1-Tema.pdf, Página 21). También, se puede fomentar la colaboración entre lingüistas computacionales y la comunidad estadística para desarrollar mejores modelos que",1386,256,1642
2.6506597995758057,¿Por qué es importante evaluar continuamente los modelos de PLN en entornos reales?,"Es importante evaluar continuamente los modelos de PLN en entornos reales debido a la necesidad de asegurar que los modelos se mantienen relevantes y precisos en contextos cambiantes. La evaluación de modelos está basada en datos, lo que implica el uso de métricas cuantitativas para comparar el rendimiento actual con investigaciones previas y garantizar que los modelos siguen siendo efectivos frente a la variabilidad de los datos del mundo real. Esto es fundamental para garantizar la validez y la efectividad de las aplicaciones de PLN, que son cada vez más interdependientes con otras áreas de la inteligencia artificial y la ciencia de datos. Además, la evolución constante de los contextos de aplicación, como en el caso de la generación de lenguaje natural y otras aplicaciones, requiere ajustes y mejoras continuas en los modelos.  (Citado del ""Archivo: 1-Tema.pdf"", Página 21)",1360,174,1534
4.414590120315552,¿Cómo se utiliza la desambiguación basada en contexto para mejorar la interpretación de palabras polisémicas?,"La desambiguación basada en contexto es una técnica crucial utilizada para mejorar la interpretación de palabras polisémicas, aquellas que tienen múltiples significados. Esta técnica se basa en el contexto en el que aparece la palabra para determinar su significado correcto. Por ejemplo, un agente conversacional debe examinar las oraciones y el diálogo que lo rodea para identificar el significado adecuado de una palabra. Esto implica un conocimiento sobre el discurso, que incluye la comprensión de las relaciones entre unidades lingüísticas en diferentes niveles de la conversación.  En términos más específicos, el agente debe ser capaz de resolver referencias cruzadas, lo que implica que debe recordar y hacer referencia a términos que ya han aparecido en la conversación. Esto es esencial para entender cómo las palabras pueden cambiar de significado según su uso en un contexto particular, así como las intenciones del usuario al formular sus preguntas o declaraciones. En resumen, la desambiguación basada en contexto permite que un agente conversacional interprete correctamente palabras polisémicas, mejorando así la calidad de la interacción.  Esta información se extrae del contexto sobre el procesamiento del lenguaje natural, donde se menciona que ""el agente examina las preguntas anteriores que se formularon previamente y utiliza el conocimiento sobre el discurso previo para resolver las referencias cruzadas"" (Tema ",4030,256,4286
5.240539789199829,¿Qué papel juegan las redes neuronales recurrentes (RNN) en la modelación de secuencias y cuáles son sus limitaciones?,"Parece que no hay un contexto proporcionado para responder a la pregunta sobre el papel de las redes neuronales recurrentes (RNN) en la modelación de secuencias y sus limitaciones. Sin información adicional, no puedo proporcionar detalles específicos sobre el tema.  Sin embargo, puedo ofrecerte una respuesta general sobre las RNN:  Las redes neuronales recurrentes (RNN) son una arquitectura de redes neuronales diseñadas para modelar datos secuenciales. Son particularmente útiles para tareas como el procesamiento del lenguaje natural, la traducción automática y el análisis de series temporales, ya que pueden retener información sobre el estado anterior gracias a su estructura de bucle, lo que les permite gestionar entradas de longitud variable.  Sin embargo, las RNN tienen varias limitaciones, entre las que se incluyen:  1. **Desvanecimiento y explosión del gradiente**: Durante el entrenamiento, las RNN pueden enfrentar problemas de desvanecimiento o explosión del gradiente, lo que dificulta la optimización efectiva en secuencias largas.  2. **Dificultad para capturar dependencias a largo plazo**: Aunque las RNN pueden recordar información a corto plazo, a menudo tienen dificultades para capturar patrones o dependencias que ocurr",140,256,396
2.0297179222106934,¿Cómo se puede medir la eficacia de un modelo de PLN en tareas específicas?,"La eficacia de un modelo de procesamiento del lenguaje natural (PLN) en tareas específicas se puede medir mediante el uso de métricas cuantitativas para la evaluación. Durante el período conocido por la unión de diferentes vertientes (1994-1999), se desarrollaron estas métricas y se enfatizó en la comparación del rendimiento de estas métricas con los resultados de investigaciones previas. Los modelos probabilísticos y basados en datos se volvieron estándares en el PLN, y los algoritmos empezaron a incorporar probabilidades y adoptar metodologías de evaluación provenientes de campos como el reconocimiento de voz y la recuperación de información (Archivo: 1-Tema.pdf, Página 21).",1438,138,1576
3.8346455097198486,¿Qué beneficios trae el uso del transfer learning en aplicaciones de PLN?,"El contexto proporcionado no menciona específicamente el transfer learning y sus beneficios en aplicaciones de procesamiento del lenguaje natural (PLN). Sin embargo, se puede deducir que el uso de técnicas de aprendizaje no supervisado, que aparecen a partir de 2005, y la interacción entre lingüistas computacionales y la comunidad estadística podrían estar relacionados con enfoques que buscan optimizar el uso de datos en PLN.   Generalmente, el transfer learning en PLN permite la reutilización de modelos preentrenados en tareas específicas, lo que puede acelerar el proceso de entrenamiento y mejorar la eficacia en tareas con datos limitados. Esto es especialmente útil en contextos donde la creación de corpus anotados es costosa y laboriosa, como se menciona respecto a la limitación que esto representa para el uso de enfoques supervisados en PLN.  Dado que la información sobre transfer learning no se encuentra explícitamente en el texto, no se incluyen citas directas.",1253,194,1447
5.512055158615112,¿Cómo se combinan técnicas de PLN y machine learning para detectar noticias falsas?,"Las técnicas de procesamiento del lenguaje natural (PLN) y aprendizaje automático (machine learning) se combinan para detectar noticias falsas a través de análisis sintáctico y semántico de los textos. El aprendizaje automático supervisado se utiliza para entrenar modelos con conjuntos de datos anotados que contienen ejemplos de noticias verídicas y falsas. Estas técnicas, como máquinas de vectores de soporte (SVM) y modelos bayesianos, permiten evaluar características del lenguaje, estructuras de dependencia y patrones semánticos para clasificar el contenido.  Además, se han empezado a aplicar también técnicas de aprendizaje no supervisado, que son útiles en contextos donde los datos anotados son limitados. Por ejemplo, el etiquetado morfosintáctico y semántico permite agrupar palabras y extraer características que ayudan a identificar la veracidad en los textos, incluso sin anotaciones previas. Estos enfoques se vuelven especialmente relevantes en la detección de noticias falsas, donde la naturaleza de los datos puede ser variada y extensa, haciendo que la flexibilidad y adaptabilidad de los modelos sean cruciales.  Para más detalles, puedes consultar ""Procesamiento del Lenguaje Natural"" (páginas 22-23).",805,249,1054
4.841171741485596,¿Qué importancia tiene la retroalimentación humana en la mejora de los modelos de PLN?,"La retroalimentación humana es crucial para la mejora de los modelos de procesamiento del lenguaje natural (PLN) porque permite a los investigadores y desarrolladores ajustar y perfeccionar estos sistemas basándose en el rendimiento real que muestran en tareas específicas. Esta interacción puede ayudar a resolver errores, ajustar parámetros de los modelos y entender mejor cómo los usuarios interactúan con las aplicaciones de PLN. Además, la retroalimentación puede servir como un recurso valioso para optimizar el uso de datos anotados y mejorar los algoritmos, principalmente en áreas donde se requiere una mayor precisión y adaptabilidad.  Específicamente, el uso de técnicas de aprendizaje automático supervisado se beneficia de esta retroalimentación, ya que permite que los modelos se entrenen con ejemplos etiquetados por humanos, lo que puede aumentar su efectividad en la comprensión y generación del lenguaje natural (Página 23, ""Procesamiento del Lenguaje Natural"").",1942,184,2126
4.326181650161743,¿Cómo se gestionan las palabras fuera de vocabulario (OOV) en modelos modernos de PLN?,"El contexto proporcionado no menciona directamente cómo se gestionan las palabras fuera de vocabulario (OOV) en modelos modernos de procesamiento del lenguaje natural (PLN). Sin embargo, es un tema común en el campo del PLN y se pueden mencionar estrategias típicas utilizadas en la gestión de OOV:  1. **Substitución por un token especial**: Las palabras OOV se reemplazan por un token especial (como `<OOV>`) que indica que la palabra no está en el vocabulario del modelo.  2. **Uso de subpalabras**: En lugar de utilizar palabras completas, algunas arquitecturas de modelos, como Byte Pair Encoding (BPE), descomponen las palabras en unidades más pequeñas (subpalabras) que pueden ser gestionadas por el modelo.  3. **Contextualización**: Modelos basados en redes neuronales pueden manejar OOV a través del contexto, utilizando embeddings que permiten inferir el significado de la palabra a partir de las palabras que la rodean.  4. **Incorporación de nuevas palabras**: Al implementar redes neuronales que permiten el aprendizaje continuo, algunas aplicaciones de PLN pueden adaptarse y ampliar su vocabulario a medida que se presentan nuevas palabras.  Si necesitas información específica sobre técnicas actuales en relación",1970,256,2226
7.253445863723755,"¿De qué manera la integración de conocimiento externo (por ejemplo, knowledge graphs) puede enriquecer los modelos de PLN?","La integración de conocimiento externo, como los knowledge graphs, puede enriquecer los modelos de PLN al proporcionar información adicional y contexto que permite una mejor comprensión y análisis del lenguaje. Estos recursos externos permiten que los modelos no solo se basen en la información textual inmediata, sino que también accedan a una red más amplia de interconexiones y significados entre entidades, lo que mejora la precisión en tareas como la desambiguación de términos, la extracción de relaciones y la comprensión semántica en general.  Además, el uso de knowledge graphs puede facilitar la generación de respuestas más informadas y relevantes en sistemas de diálogo, así como permitir un mejor razonamiento sobre el contenido que se está procesando, ya que los modelos pueden hacer referencia a relaciones conocidas y contextos que van más allá del texto explícito. Esto es especialmente útil en aplicaciones donde se requiere un entendimiento profundo de las interrelaciones entre diferentes conceptos.  En resumen, el conocimiento externo amplía la capacidad de los modelos de PLN para interpretar y manipular información compleja de manera más efectiva, mejorando así su desempeño en diversas aplicaciones.",2283,223,2506
4.957048416137695,¿Cómo contribuye la normalización de texto a la reducción de sesgos en los modelos de PLN?,"La normalización de texto contribuye a la reducción de sesgos en los modelos de procesamiento del lenguaje natural (PLN) al asegurar que el modelo procese entradas de manera más uniforme y coherente. Esto incluye la conversión de diferentes formas de una palabra o frase a una forma estándar, eliminando variaciones que podrían llevar a interpretaciones erróneas o sesgadas del significado. Al hacer que el texto sea más homogéneo, se minimizan las diferencias que pueden ser influenciadas por factores externos como la cultura, el dialecto o las preferencias personales, lo que permite que el modelo se enfoque en el contenido y significado real del texto.  Además, la normalización elimina elementos de ruido en los datos, lo que proporciona una mejor calidad en la entrada del modelo y, por ende, mejora sus predicciones y análisis. De este modo, al reducir la variabilidad y el sesgo potencial en las entradas, la normalización juega un papel clave en la creación de modelos de PLN más justos y representativos.   Para más detalles sobre el enfoque en aprendizaje automático y cómo afecta el procesamiento, puedes consultar ""Ideas clave"" (pág. 21) y ""Historia del procesamiento del lenguaje natural"" (pág. 13).",2792,253,3045
2.8944578170776367,¿Qué papel tiene la evaluación automatizada en el ciclo de desarrollo de modelos de PLN?,"La evaluación automatizada desempeña un papel crucial en el ciclo de desarrollo de modelos de procesamiento del lenguaje natural (PLN). Durante el período mencionado en el contexto, se desarrollaron métricas cuantitativas para la evaluación de los modelos, enfatizando la comparación del rendimiento de estas métricas con los resultados de investigaciones previas. Este enfoque empírico se basa en datos y es fundamental para asegurar que los modelos de PLN son precisos y efectivos en sus tareas.  Además, la evaluación de modelos presupone una metodología rigurosa que permite a los investigadores y desarrolladores mejorar continuamente sus algoritmos. Esto se traduce en mejores resultados en aplicaciones prácticas de PLN, como el reconocimiento de voz y la recuperación de información.  Título: ""Aplicaciones del Procesamiento del Lenguaje Natural"", Página 21.",1580,162,1742
3.010474920272827,¿Cómo influye el diseño del corpus en la detección y análisis de opiniones en redes sociales?,"El diseño del corpus influye significativamente en la detección y análisis de opiniones en redes sociales, ya que un corpus bien diseñado permitirá aplicar de manera efectiva técnicas de procesamiento del lenguaje natural (PLN) y algoritmos de aprendizaje automático. Al recopilar y seleccionar textos relevantes de redes sociales, se puede asegurar que el procesamiento posterior refleje de manera precisa las opiniones de los usuarios. Esto es esencial para poder clasificar el sentimiento, ya sea positivo, negativo o neutro, hacia un producto o marca. Un corpus que contemple diversidad en términos de lenguaje, contextos y métricas puede facilitar el análisis y mejorar la eficacia de los modelos de clasificación utilizados para interpretar las opiniones expresadas en plataformas sociales (Tema 1, página 11).",604,150,754
1.9781811237335205,¿Qué estrategias se pueden utilizar para mejorar la precisión en tareas de traducción automática?,"Para mejorar la precisión en tareas de traducción automática, se pueden utilizar métodos estadísticos basados en frases. Estos métodos analizan grandes conjuntos de datos mediante aprendizaje automático, lo que permite realizar traducciones que no se limitan a las cuestiones gramaticales. Además, es importante contar con herramientas para solventar la ambigüedad de las palabras, como serían los algoritmos de desambiguación.  (Tema 1. Ideas clave, pág. 10)",1035,96,1131
11.213769674301147,¿Cómo se relaciona la estructura gramatical con el éxito de un modelo de PLN?,"La estructura gramatical juega un papel crucial en el éxito de un modelo de Procesamiento de Lenguaje Natural (PLN), ya que permite al sistema interpretar correctamente el significado y la intención de las frases. Un modelo que comprende la sintaxis y la gramática puede descomponer oraciones complejas, identificar relaciones entre diferentes partes de una oración y así ejecutar tareas como el análisis sintáctico y semántico con mayor precisión.  La relación entre la gramática y el PLN se hace evidente en el uso de gramáticas transformacionales y otros modelos estructurales que han sido fundamentales en la historia del PLN. Estos modelos han permitido que los sistemas desarrollen una comprensión más profunda del lenguaje, lo que se traduce en un mejor rendimiento en tareas como la traducción automática o la generación de lenguaje natural (PLN, 1.4, p. 8).  Además, la evolución hacia enfoques de aprendizaje automático y modelos basados en datos ha fortalecido aún más esta relación. La capacidad de los modelos para interpretar la estructura gramatical se ha visto potenciada por la disponibilidad de corpus anotados y la utilización de técnicas que permiten a los sistemas aprender patrones y relaciones lingüísticas a partir de los datos (PLN, 1.5, p.",2762,256,3018
3.3546717166900635,¿Qué retos plantea la actualización constante de modelos de PLN en entornos de rápida evolución tecnológica?,"La actualización constante de modelos de Procesamiento del Lenguaje Natural (PLN) en entornos de rápida evolución tecnológica plantea varios retos, entre los cuales destacan:  1. **Cambio de Datos**: Los modelos de PLN deben adaptarse a nuevos datos que a menudo tienen diferentes formas, estilos y contextos lingüísticos. La variabilidad en los datos puede afectar la precisión y la efectividad del modelo a lo largo del tiempo.  2. **Mantenimiento de Corpus Anotados**: La producción de corpus anotados es costosa y difícil, lo que representa un factor limitante para el uso de enfoques supervisados. Por lo tanto, se requiere un esfuerzo continuo para mantener y actualizar estos corpus para que los modelos se mantengan relevantes (Página 23).  3. **Integración de Técnicas de Aprendizaje No Supervisado**: La tendencia hacia el uso de técnicas de aprendizaje no supervisado se ha incrementado, lo que trae consigo la necesidad de desarrollar estrategias para construir aplicaciones lingüísticas a partir de datos no anotados, generando nuevos retos en la calidad y aplicabilidad de los modelos (Página 23).  4. **Evaluación Consistente**: Con el desarrollo de métricas cuantitativas y la necesidad de comparar constantemente el rendimiento de los",1441,256,1697
4.161924123764038,¿Cuáles son las limitaciones de los enfoques tradicionales en PLN y cómo las superan los métodos basados en deep learning?,"Las limitaciones de los enfoques tradicionales en el Procesamiento del Lenguaje Natural (PLN) incluyen:  1. **Dependencia de reglas rígidas**: Muchos sistemas tradicionales se basaban en reglas y heurísticas fijas, lo que limitaba su capacidad para adaptarse a la variabilidad del lenguaje natural.     2. **Necesidad de corpus anotados**: Los enfoques supervisados requerían grandes cantidades de datos anotados, lo que resultaba costoso y complicado de producir, convirtiéndose en un factor limitante (Página 12).  3. **Dificultades en la gestión de la complejidad**: A medida que los problemas se volvían más complejos, el uso de estadísticas simple, como los modelos bayesianos, o modelos probabilísticos ya no eran suficientes para abordar tareas que implican el análisis sintáctico y semántico (Página 23).  Los métodos basados en deep learning superan estas limitaciones de las siguientes maneras:  1. **Modelos flexibles y adaptativos**: Las redes neuronales profundas pueden aprender representaciones complejas de los datos, permitiendo una mejor generalización a situaciones no vistas. Esto les permite manejar mejor la variabilidad y complejidad del lenguaje natural.  2",2624,256,2880
3.31108021736145,¿Cómo se puede evaluar la robustez de un modelo de PLN ante textos con lenguaje figurado o irónico?,"La robustez de un modelo de PLN ante textos con lenguaje figurado o irónico se puede evaluar mediante la aplicación de métricas específicas que registren la capacidad del modelo para interpretar correctamente el contexto y el significado implícito. Los modelos deben ser capaces de diferenciar entre el lenguaje literal y figurado, así como de reconocer las sutilezas de la ironía, lo que a menudo requiere un entrenamiento adicional con corpus que incluyan ejemplos de estas variantes.  Además, es fundamental realizar pruebas con conjuntos de datos que contengan una mezcla de fenómenos de lenguaje figurado e irónico para medir no solo la precisión en la identificación de las intenciones del hablante, sino también cómo el modelo maneja las ambigüedades y las inferencias que estos tipos de lenguaje generan.  Esta evaluación puede incluir la construcción de casos de prueba donde el lenguaje figurado e irónico esté presente de manera destacada, y se puede usar un enfoque de evaluación cualitativa mediante análisis de errores, donde se revisen los ejemplos en los que el modelo falla y se analicen las razones detrás de estas fallas.",2846,225,3071
4.9895713329315186,¿De qué manera la incorporación de knowledge graphs puede mejorar la capacidad inferencial de un modelo de PLN?,"La incorporación de knowledge graphs puede mejorar la capacidad inferencial de un modelo de PLN al proporcionar una estructura semántica rica y conectada que permite un mejor entendimiento de las relaciones entre los conceptos. Estos gráficos ofrecen un contexto más amplio que ayuda a los modelos a realizar deducciones y conexiones que no serían posibles solo con el análisis superficial del texto.  Por ejemplo, en el contexto del PLN, los knowledge graphs pueden ser utilizados para mejorar las tareas de desambiguación de palabras, facilitar la inferencia y enriquecer el análisis semántico, ya que incorporan información sobre la jerarquía, propiedades y relaciones de entidades. Esto permite a los modelos inferir información adicional basada en lo que ya conocen, lo cual es esencial para mejorar la comprensión y el procesamiento del lenguaje natural en diversas aplicaciones, desde la generación de lenguaje natural hasta el análisis de sentimientos.  Aunque el contexto específico no menciona directamente los knowledge graphs, se deja entrever su relevancia en la mejora del procesamiento del lenguaje al referirse a temas como la estructura semántica y el análisis más profundo en la evolución del PLN (1-Tema.pdf, Página 23).",2043,232,2275
9.47146725654602,¿Qué desafíos éticos surgen al implementar sistemas de PLN en contextos sensibles y cómo se pueden mitigar?,"El contexto proporcionado no aborda específicamente los desafíos éticos que surgen al implementar sistemas de Procesamiento del Lenguaje Natural (PLN) en contextos sensibles. Sin embargo, en general, algunos de los desafíos éticos que se podrían considerar incluyen:  1. **Privacidad de los datos**: El uso de PLN podría implicar la recolección y análisis de información personal sensible, lo cual requiere un manejo cuidadoso para proteger la privacidad de los individuos.  2. **Sesgos en los algoritmos**: Los modelos de PLN pueden estar sesgados si se entrenan con datos que no son representativos, lo que puede llevar a decisiones injustas, por ejemplo, en la criba curricular.  3. **Transparencia y explicabilidad**: Es fundamental que los usuarios comprendan cómo funciona un sistema de PLN, y cómo se toman las decisiones basadas en su análisis, especialmente en contextos como Recursos Humanos.  4. **Dependencia tecnológica**: Implementar tecnologías de PLN puede llevar a una dependencia excesiva, donde se subestime la importancia del juicio humano en la toma de decisiones.  Para mitigar estos desafíos, se pueden adoptar varias estrategias, como implementar políticas rigurosas de gobernanza de datos, realizar auditorías frecuentes para detectar y",409,256,665
5.025110244750977,¿Cómo influye la calidad del corpus en la capacidad de un modelo para generalizar a dominios específicos?,"La calidad del corpus tiene un impacto significativo en la capacidad de un modelo para generalizar a dominios específicos. Cuando se cuenta con corpus anotados de alta calidad, se facilita el aprendizaje automático supervisado, lo que permite a los modelos absorber características relevantes del lenguaje y aplicarlas de manera efectiva en situaciones similares. Sin embargo, el coste y la dificultad de producir estos corpus anotados se convierten en un factor limitante. Esto ha llevado a una tendencia hacia el uso de técnicas de aprendizaje no supervisado, que permiten trabajar con datos sin anotación, pero también pueden influir en la capacidad de generalización del modelo, ya que dependen menos de ejemplos específicos y más de patrones subyacentes en los datos no estructurados.  En resumen, un corpus de calidad es crucial para mejorar la generalización de los modelos en dominios específicos, mientras que la escasez de recursos anotados impulsa la exploración de enfoques no supervisados, que presentan sus propias ventajas y limitaciones.  Referencia: Procesamiento del Lenguaje Natural, página 23.",959,214,1173
4.3398168087005615,"¿Cuáles son las principales diferencias en la implementación de tokenización basada en palabras versus tokenización subword, y qué implicaciones tiene cada una?","Actualmente no hay un contexto proporcionado para responder a tu pregunta sobre las diferencias en la implementación de tokenización basada en palabras versus tokenización subword. Sin embargo, puedo darte una idea general.  La **tokenización basada en palabras** divide el texto en palabras completas. Esto es simple y efectivo para muchos idiomas donde las palabras están bien definidas, pero tiene limitaciones con vocabularios grandes, variaciones lingüísticas y palabras desconocidas. Además, puede llevar a problemas de manejo de OOV (out-of-vocabulary).  Por otro lado, la **tokenización subword** se basa en fragmentar palabras en unidades más pequeñas que pueden ser morfemas o sílabas. Este enfoque permite un manejo más efectivo de vocabularios grandes y puede minimizar el problema de OOV al descomponer palabras desconocidas en componentes que son reconocibles. Sin embargo, la tokenización subword puede introducir complejidades adicionales en el procesamiento y en la interpretación del significado de las unidades.  Las implicaciones de cada tipo de tokenización se ven reflejadas en el rendimiento de los modelos de procesamiento de lenguaje natural, donde la tokenización subword suele resultar en mejores resultados para tareas de modelado de lenguaje y traducción automática debido a su flexibilidad y capacidad de general",140,256,396
7.06108021736145,¿Qué papel juega el mecanismo de atención en la mejora de la traducción automática y la generación de texto?,"El contexto proporcionado no menciona específicamente el mecanismo de atención en la mejora de la traducción automática y la generación de texto. Sin embargo, se puede inferir que las técnicas avanzadas de procesamiento del lenguaje natural, como la traducción automática y la generación de lenguaje, se benefician del aprendizaje automático, el cual ha sido fundamental para el desarrollo de algoritmos que manejan mejor las complejidades del lenguaje.  Generalmente, el mecanismo de atención permite a los modelos centrarse en partes relevantes del texto de entrada a medida que producen una traducción o texto generado, facilitando que las máquinas comprendan mejor el contexto y las relaciones entre las palabras y frases, lo que a su vez mejora la calidad de las traducciones automáticas y el contenido generado.  Si necesitas información más específica sobre el mecanismo de atención, no dudes en preguntar.",2908,170,3078
3.6849679946899414,¿Cómo se pueden mitigar los errores de desambiguación semántica en modelos de PLN mediante el uso de contexto ampliado?,"Para mitigar los errores de desambiguación semántica en modelos de PLN, se puede recurrir al uso de contexto ampliado, el cual permite comprender mejor el significado de las palabras y expresiones en función de su uso en oraciones o diálogos más extensos. Este enfoque ayuda a considerar la información que rodea a las palabras, lo que es especialmente útil para seleccionar el significado correcto en situaciones donde una misma palabra puede tener múltiples interpretaciones. La utilización del contexto más allá de la oración inmediata contribuye a tomar decisiones más acertadas en la interpretación semántica de los textos.  Esta estrategia se relaciona con la necesidad de un conocimiento adecuado sobre el discurso, ya que el agente conversacional o el modelo de PLN debe ser capaz de resolver referencias cruzadas y entender la intención del usuario al examinar lo que se ha dicho anteriormente. Así, se pueden evitar confusiones y mejorar la precisión en las tareas de procesamiento del lenguaje natural, como la respuesta a preguntas o la interpretación de comandos. (Proceso de PLN, página 29)",3163,213,3376
3.7671525478363037,¿Qué estrategias se pueden implementar para mejorar la interpretabilidad de modelos complejos en PLN?,"El contexto proporcionado no menciona explícitamente estrategias específicas para mejorar la interpretabilidad de modelos complejos en procesamiento de lenguaje natural (PLN). Sin embargo, en el ámbito de PLN, algunas estrategias comunes que se pueden implementar incluyen:  1. **Modelos más simples**: Utilizar modelos más interpretable en lugar de técnicas de ""caja negra"" como el deep learning, donde los resultados son más comprensibles. 2. **Visualización de decisiones**: Crear visualizaciones que muestren cómo un modelo toma decisiones y qué características son más influyentes en su resultado. 3. **Métodos de ajuste explicativo**: Aplicar técnicas como LIME (Local Interpretable Model-agnostic Explanations) para proporcionar explicaciones locales sobre la predicción de un modelo. 4. **Feature Importance**: Evaluar la importancia de las características para entender qué datos influyen más en las decisiones del modelo. 5. **Análisis de Sensibilidad**: Realizar análisis de sensibilidad para ver cómo pequeños cambios en la entrada afectan a la salida, lo que puede ofrecer perspectivas sobre la robustez y las decisiones del modelo. 6. **Empatía con el usuario**: Incorporar feedback humano y enfoques de explicabilidad centrados en",2700,256,2956
4.992461442947388,¿De qué forma el transfer learning ha modificado el panorama del desarrollo de modelos de PLN para tareas específicas?,"El transfer learning ha transformado significativamente el desarrollo de modelos de procesamiento de lenguaje natural (PLN), especialmente para tareas específicas. Este enfoque permite que un modelo previamente entrenado en una gran cantidad de datos generales sea adaptado a una tarea particular con un conjunto de datos más reducido. Esta técnica ha hecho que la creación de modelos de PLN sea más accesible y eficiente, ya que reduce la necesidad de contar con grandes cantidades de datos anotados para cada tarea específica. De este modo, los investigadores y desarrolladores pueden aprovechar modelos preentrenados y ajustarlos según sus necesidades, lo que resulta en un rendimiento mejorado en tareas específicas de PLN.  Este cambio se ha visto impulsado por el auge del aprendizaje automático y la disponibilidad de grandes conjuntos de datos, que anteriormente fueron utilizados para entrenar dichos modelos generales. Así, el transfer learning se presenta como una estrategia que facilita la innovación y mejora la implementación de soluciones basadas en el PLN, permitiendo aplicaciones eficientes y efectivas incluso en contextos donde los datos son limitados.   Para más detalles sobre el contexto histórico y metodológico que rodea este fenómeno, se puede consultar el documento ""Procesamiento del Lenguaje Natural"" (Página 27).",2634,243,2877
2.6582674980163574,¿Cómo se puede medir la eficacia de un modelo de PLN en la detección de noticias falsas?,"La eficacia de un modelo de procesamiento del lenguaje natural (PLN) en la detección de noticias falsas se puede medir a través de métricas cuantitativas que evalúan el rendimiento del modelo basado en datos. Esto incluye la comparación de sus resultados con investigaciones previas y el uso de algoritmos que incorporen probabilidades. Además, es importante adoptar metodologías de evaluación que provengan de otros ámbitos, como el reconocimiento de voz y la recuperación de información, para obtener una comparación más robusta y efectiva.  Específicamente, al evaluar un modelo de PLN, se pueden considerar métricas como la precisión, la recuperación, y la puntuación F1. Estas métricas proporcionan un marco que permite analizar qué tan bien el modelo identifica noticias falsas en comparación con un conjunto de datos de referencia. En resumen, la evaluación del modelo debe ser integral y adaptarse a estándares establecidos para asegurar su efectividad en la detección de noticias falsas (Archivo: 1-Tema.pdf, Página 21).",516,204,720
4.593652248382568,"¿Qué implicaciones tiene la integración de datos multimodales (texto, imagen, audio) en los modelos de PLN?","La integración de datos multimodales en los modelos de Procesamiento del Lenguaje Natural (PLN) tiene varias implicaciones importantes:  1. **Enriquecimiento del contexto**: Incluir diferentes modalidades, como texto, imagen y audio, permite a los modelos entender la información de manera más completa y contextual. Por ejemplo, un texto puede ser interpretado de forma diferente cuando se considera junto a una imagen o un clip de audio relacionado.  2. **Mejora en la precisión**: La combinación de datos de múltiples fuentes puede aumentar la precisión de las tareas de PLN, como el etiquetado semántico y el análisis de sentimientos. Al tener información de texto y correlacionarla con imágenes o sonidos, se pueden reducir ambigüedades y mejorar la comprensión del contenido.  3. **Nuevas aplicaciones**: La integración de datos multimodales abre la puerta a nuevas aplicaciones y casos de uso en el PLN. Por ejemplo, en recursos humanos, se podría analizar no solo el texto de un currículum, sino también videos de entrevistas, lo cual podría ofrecer una evaluación más holística de un candidato.  4. **Desafíos computacionales**: Sin embargo, la fusión de datos multimodales también presenta desafíos, como",1587,256,1843
5.651165723800659,¿Cómo se puede abordar el problema de los sesgos en los modelos de PLN derivados de datos de entrenamiento poco representativos?,"El problema de los sesgos en los modelos de procesamiento del lenguaje natural (PLN) que derivan de datos de entrenamiento poco representativos se puede abordar a través de varias estrategias:  1. **Diversificación de los Datos**: Aumentar la diversidad de los datos de entrenamiento, asegurando que sean representativos de la población o del contexto en el que se aplicará el modelo. Esto incluye la recopilación de datos de diversas fuentes y garantizar que se incluyan diferentes dialectos, géneros y contextos culturales.  2. **Uso de Técnicas de Aprendizaje No Supervisado**: A partir de 2005, se observa una tendencia hacia el uso de técnicas de aprendizaje no supervisado en el procesamiento del lenguaje natural. Estas técnicas permiten construir aplicaciones lingüísticas a partir de datos sin anotación alguna, lo que podría ayudar a mitigar los sesgos al reducir la dependencia de corpus anotados que puedan estar sesgados (Archivo: 1-Tema.pdf, Página 23).  3. **Técnicas de Análisis de Sesgos**: Implementar herramientas y metodologías que evalúen y detecten sesgos en los datos y en las salidas de los modelos. Esto puede incluir pruebas de equidad que analicen si las decisiones",1238,256,1494
4.988447427749634,¿Qué ventajas ofrece el uso de modelos basados en Transformers frente a las RNN tradicionales en el procesamiento de secuencias?,"Parece que no hay un contexto relevante proporcionado en el mensaje. Sin embargo, puedo resumir las ventajas de los modelos basados en Transformers en comparación con las RNN tradicionales en el procesamiento de secuencias.   1. **Paralelización**: Los Transformers permiten el procesamiento de secuencias en paralelo, lo que hace que sean mucho más rápidos en el entrenamiento, especialmente con grandes conjuntos de datos.  2. **Atención y contexto**: Utilizan mecanismos de atención que permiten a los modelos focalizarse en diferentes partes de la entrada de manera más efectiva, mejorando la comprensión del contexto a lo largo de la secuencia.  3. **Dependencias a largo plazo**: A diferencia de las RNN, que tienden a tener dificultades con las dependencias a largo plazo debido al desvanecimiento del Gradiente, los Transformers manejan mejor estas relaciones.  4. **Flexibilidad en la longitud de las secuencias**: Los modelos Transformer pueden manejar secuencias de diferentes longitudes más fácilmente, ya que no están restringidos por la estructura secuencial de las RNN.  5. **Resultados en tareas de NLP**: Han demostrado un rendimiento superior en muchas tareas de procesamiento de lenguaje natural, como traducción automática y",136,256,392
3.8696377277374268,¿Cómo influye el preprocesamiento en la eliminación de ruido y en la mejora del rendimiento de un modelo de PLN?,"El preprocesamiento en el procesamiento del lenguaje natural (PLN) es crucial para la eliminación de ruido y la mejora del rendimiento de un modelo. Este proceso implica limpiar y estructurar los datos de texto antes de que sean alimentados al modelo, lo que puede incluir la eliminación de caracteres innecesarios, la normalización del texto (como convertir todo a minúsculas o eliminar puntuaciones), y la eliminación de palabras poco informativas (stop words).   Tales acciones suelen resultar en una representación más clara y precisa de los datos, facilitando que el modelo identifique patrones y relaciones relevantes, lo que a su vez mejora su rendimiento general en tareas como la clasificación, el análisis de sentimientos o la traducción automática. Por lo tanto, al reducir el ruido en los datos, el preprocesamiento ayuda a que los modelos de PLN sean más eficientes y efectivos, permitiendo una mejor comprensión del contenido del lenguaje.  Este enfoque es especialmente importante en aplicaciones prácticas de PLN, donde grandes volúmenes de texto pueden contener mucho ruido. La capacidad de un sistema para filtrar este ruido puede determinar si el modelo logra su objetivo con éxito.  Aunque no se citó de manera directa un pasaje que trate específicamente sobre el preprocesamiento en la información proporcionada, la importancia",1650,256,1906
4.658337354660034,¿Qué desafíos presenta la actualización en tiempo real de modelos de PLN en entornos dinámicos?,"El contexto proporcionado no aborda específicamente los desafíos de la actualización en tiempo real de modelos de PLN en entornos dinámicos. Sin embargo, se pueden inferir algunos desafíos generales que podrían estar relacionados con este tema:  1. **Costo y dificultad de producir corpus anotados**: La producción de datos anotados es costosa y laboriosa, lo cual es un factor limitante en el uso de enfoques supervisados. Esto es relevante porque la actualización frecuente requeriría nuevos datos anotados para mantener la precisión del modelo en entornos dinámicos (página 23).  2. **Interacción con técnicas de aprendizaje no supervisado**: Con el surgimiento de técnicas de aprendizaje no supervisado, se ha avanzado en la construcción de aplicaciones lingüísticas a partir de datos no anotados. Sin embargo, esto puede presentar desafíos al intentar adaptar modelos entrenados a nuevas informaciones y variaciones en los patrones del lenguaje (página 23).  3. **Evaluación y comparación de rendimiento**: La necesidad de evaluar continuamente el rendimiento de los modelos en entornos cambiantes puede complicar la implementación de actualizaciones en tiempo real, ya que se deben desarrollar métricas cuantitativas que permitan una comparación efectiva con investigaciones anteriores (página 21).  4. **",1441,256,1697
5.530404567718506,¿Cómo se puede utilizar la retroalimentación de usuarios para ajustar y mejorar los modelos de PLN en aplicaciones prácticas?,"La retroalimentación de usuarios puede ser utilizada para ajustar y mejorar los modelos de PLN en aplicaciones prácticas a través de la incorporación de comentarios directos sobre el rendimiento y la precisión de los modelos. Esta retroalimentación puede incluir ejemplos específicos de errores, ajustes en las instrucciones de los usuarios o expectativas no cumplidas en las salidas de los modelos. Al analizar esta información, los desarrolladores pueden identificar patrones comunes en los errores y realizar ajustes en los algoritmos para mejorar su rendimiento.  Además, es posible implementar un ciclo de retroalimentación donde los usuarios proporcionen información regularmente. Esto permite el entrenamiento continuo de los modelos, ajustando los parámetros y perfeccionando las técnicas de aprendizaje automático con cada nueva sesión de uso. Por ejemplo, en aplicaciones que reciben una gran cantidad de datos, las técnicas de PLN se pueden utilizar para procesar y analizar esta retroalimentación masiva, ayudando a extraer información relevante que informe sobre las áreas que requieren mejoras (Página 12).  Por tanto, la combinación de la retroalimentación de los usuarios y la implementación de técnicas de aprendizaje automático supervisado o no supervisado puede facilitar un proceso dinámico y adaptable en la mejora de los modelos de PLN (Página 23).",1684,246,1930
5.85683536529541,¿Qué papel juegan las técnicas de data augmentation en el fortalecimiento de modelos de PLN?,"El documento proporcionado no menciona específicamente las técnicas de ""data augmentation"" en el contexto del Procesamiento del Lenguaje Natural (PLN). Sin embargo, en general, las técnicas de data augmentation juegan un papel crucial en el fortalecimiento de los modelos de PLN al permitir la creación de datos adicionales a partir de los existentes. Esto es especialmente útil en situaciones donde los corpus anotados son limitados, como se menciona en el contexto, donde el costo y la dificultad de producir corpus anotados pueden limitar el uso de enfoques supervisados.  El ""data augmentation"" puede incluir modificaciones en los textos, como sinónimos, cambios de estructura de frases o variaciones en la forma gramatical, lo que ayuda a los modelos de PLN a generalizar mejor y volverse más robustos frente a la variabilidad del lenguaje. Esto puede repercutir en un mejor rendimiento en tareas como el etiquetado morfosintáctico, el análisis sintáctico y semántico, donde la cantidad y diversidad de datos de entrenamiento son vitales para el éxito del modelo.  Aunque el documento no ofrece detalles específicos sobre técnicas de data augmentation, su rol sería fundamental para abordar los problemas complejos de PLN mencionados en el texto, promoviendo el aprendizaje de los",2041,256,2297
4.677863359451294,¿Cómo afecta la complejidad del lenguaje natural a la hora de diseñar modelos de PLN capaces de captar sutilezas semánticas?,"La complejidad del lenguaje natural afecta significativamente el diseño de modelos de procesamiento del lenguaje natural (PLN) que buscan captar sutilezas semánticas. Esta complejidad implica la necesidad de un conocimiento profundo del lenguaje, lo que supera las capacidades de sistemas más simples. Los modelos deben poder manejar no solo la estructura gramatical, sino también interpretar el significado subyacente y las relaciones entre diferentes partes del discurso.  Los sistemas avanzados, como los agentes conversacionales y los sistemas de traducción automática, requieren este conocimiento extenso para poder discernir contextos y significados implícitos, lo cual es esencial para la correcta interacción con los usuarios y la generación de respuestas significativas. Esto contrasta con aplicaciones más simples que pueden limitarse a tareas básicas de conteo o procesamiento de datos sin involucrar un nivel de comprensión semántica.  Además, la necesidad de analizar y comprender la pragmática del lenguaje, es decir, cómo el contexto influye en la interpretación de las palabras, añade otro nivel de complejidad que los modelos deben abordar. Esto hace que la diseñación de modelos de PLN sea un desafío considerable, especialmente cuando se intenta trabajar con lenguaje humano en su totalidad (Archivo: 1-Tema.pdf, página 27).",2677,256,2933
8.523079872131348,¿Por qué es crucial la evaluación continua de modelos en producción y cuáles son los métodos para llevarla a cabo?,"El contexto proporcionado no aborda directamente la cuestión de la evaluación continua de modelos en producción ni los métodos para llevarla a cabo. Sin embargo, se menciona que ""en este período, se desarrollaron métricas cuantitativas para la evaluación y se enfatizó en la comparación del rendimiento de estas métricas con los resultados de las investigaciones previas"", lo cual sugiere la importancia de establecer métricas de evaluación durante el desarrollo de modelos.  La evaluación continua de modelos en producción es crucial porque permite asegurar que el rendimiento del modelo se mantenga a lo largo del tiempo y que siga siendo relevante ante cambios en los datos o en el entorno. Sin métodos específicos de evaluación y monitoreo, un modelo puede degradarse en su rendimiento sin ser detectado, lo que podría llevar a decisiones erróneas basadas en resultados obsoletos.  Para llevar a cabo esta evaluación continua, se pueden utilizar varios métodos, tales como:  1. **Métricas de rendimiento**: Implementar métricas cuantitativas que midan el rendimiento del modelo de forma regular. 2. **Comparación con benchmarks**: Comparar el rendimiento del modelo actual con resultados previos o benchmarks establecidos. 3. **Monitoreo de datos**: Analizar cambios en la distribución de",795,256,1051
6.445976257324219,¿Qué estrategias se pueden aplicar para optimizar la eficiencia computacional sin sacrificar la precisión en modelos de PLN?,"El contexto proporcionado no menciona directamente estrategias específicas para optimizar la eficiencia computacional en modelos de procesamiento de lenguaje natural (PLN) sin sacrificar la precisión. Sin embargo, dado el ámbito del PLN, se pueden considerar algunas prácticas generales que son comunes en este campo:  1. **Uso de Técnicas de Filtrado**: Implementar técnicas de preprocesamiento para reducir la cantidad de datos mediante la eliminación de ruido, lo que puede mejorar la eficiencia sin comprometer la precisión del análisis.  2. **Modelos Más Pequeños o Específicos**: Optar por modelos más pequeños o especializados que requieren menos recursos computacionales y son más rápidos, especialmente si se sabe que el dominio de la tarea es específico (como la cribado curricular en Recursos Humanos).  3. **Optimización de Algoritmos**: Implementar algoritmos de aprendizaje automático optimizados que puedan ejecutar tareas de PLN de manera más eficiente, como aquellos que utilizan menos memoria o hacen un uso más eficaz de la CPU/GPU.  4. **Paralelización**: Utilizar técnicas de paralelización y procesamiento distribuido para realizar tareas en múltiples núcleos o máquinas, acelerando el tiempo de procesamiento.  5. **Uso de Batch Processing**: Implementar",409,256,665
3.8434481620788574,¿Cómo se integran métodos de aprendizaje supervisado y no supervisado para enriquecer la comprensión del lenguaje en modelos híbridos?,"Los métodos de aprendizaje supervisado y no supervisado se integran en modelos híbridos para enriquecer la comprensión del lenguaje al combinar las fortalezas de ambos enfoques. El aprendizaje supervisado, que se basa en datos anotados, permite resolver problemas complejos de análisis sintáctico y semántico, utilizando técnicas como máquinas de vectores de soporte (SVM) y modelos bayesianos, proporcionando una estructura inicial sólida a los modelos. Por otro lado, el aprendizaje no supervisado es útil para construir aplicaciones lingüísticas a partir de datos no anotados, lo que permite abordar la escasez de recursos anotados y adaptarse a una mayor variedad de datos desconocidos, como en la traducción automática o el modelado de temas.  Esta integración de enfoques permite a los modelos híbridos obtener una comprensión más completa y flexible del lenguaje, aprovechando la precisión y estructura del aprendizaje supervisado y la adaptabilidad y generalidad del aprendizaje no supervisado.   Para más detalles, se puede consultar el documento ""Procesamiento del Lenguaje Natural"" en la página 23.",3882,221,4103
6.212280511856079,¿Qué desafíos presentan los idiomas con pocos recursos y cómo se pueden superar en el desarrollo de modelos de PLN?,"Los idiomas con pocos recursos presentan desafíos significativos en el desarrollo de modelos de procesamiento del lenguaje natural (PLN), como la falta de corpus anotados y datos de entrenamiento adecuados. Estos idiomas a menudo carecen de recursos lingüísticos disponibles, tales como diccionarios, gramáticas o textos, lo que dificulta la creación de modelos eficientes. Además, las características específicas de estos idiomas, como la morfología rica o estructuras sintácticas complejas, pueden complicar aún más el procesamiento.  Para superar estos desafíos, se pueden adoptar varias estrategias. Una opción es hacer uso de técnicas de aprendizaje no supervisado, que permiten construir aplicaciones lingüísticas a partir de datos no anotados, facilitando así el desarrollo de modelos en idiomas con escasa información disponible (página 23). Otra estrategia es fomentar la creación de corpus anotados a nivel comunitario, involucrando a hablantes nativos y lingüistas para que colaboren en documentar y anotar el idioma. Además, pueden aprovecharse transferencias desde idiomas con recursos más robustos, aplicando enfoques de aprendizaje transferido que utilizan modelos preentrenados en idiomas más ricos y adaptándolos a los idiomas menos representados (página 25).  Estas tácticas permiten avanzar en el procesamiento de idiomas",2686,256,2942
4.22719407081604,¿Cómo influye la estructura gramatical del idioma en la elección de técnicas y algoritmos para el procesamiento del lenguaje?,"La estructura gramatical del idioma influye significativamente en la elección de técnicas y algoritmos para el procesamiento del lenguaje natural (PLN) debido a varios factores relacionados con la complejidad y diversidad de los lenguajes.   En primer lugar, el análisis sintáctico y la interpretación semántica requieren una comprensión de las relaciones estructurales entre las palabras y las reglas gramaticales. Por ello, los enfoques que emplean gramáticas formales, como las gramáticas transformacionales, son fundamentales para desarrollar algoritmos que puedan ayudar a descomponer oraciones en sus componentes constitutivos y entender su significado (Tema 1, página 16).  Además, las diferentes estructuras de los idiomas —incluyendo variaciones en la morfología, la fonología y la pragmática— implican que las técnicas de aprendizaje automático deben ajustarse a las especificidades de cada lengua. Esto se observa en la utilización de algoritmos que integran conocimientos sobre la gramática y el léxico del idioma específico que se está procesando (Tema 1, página 6).   Estas características gramaticales también tienen un impacto en la elección entre métodos de aprendizaje supervisado y no supervisado, así como en el desarrollo de sistemas específicos que",3050,256,3306
4.674536943435669,¿Qué papel juega la experimentación controlada en el ajuste fino de modelos de PLN y cómo se lleva a cabo?,"La experimentación controlada juega un papel crucial en el ajuste fino de modelos de procesamiento del lenguaje natural (PLN), ya que permite evaluar y comparar el rendimiento de diferentes modelos y métodos de aprendizaje en relación con tareas específicas. En el contexto del PLN, esto implica el establecimiento de métricas cuantitativas para la evaluación y la comparación con resultados de investigaciones previas. A través de este enfoque, se busca optimizar los modelos mediante el ajuste de parámetros y la validación en conjuntos de datos específicos.  Este paradigma empírico, que surgió en los años 90, se caracteriza por la incorporación de modelos probabilísticos y basados en datos, donde los algoritmos de análisis y etiquetado comenzaron a adoptar metodologías de evaluación. En este sentido, la experimentación controlada se lleva a cabo analizando rigurosamente diferentes enfoques y ajustando parámetros en función de los resultados obtenidos en la evaluación (Archivo: 1-Tema.pdf, Página 21).   De esta forma, la experimentación controlada facilita una mejora continua y adaptación de los modelos a los desafíos del procesamiento del lenguaje, permitiendo así una evolución significativa en el campo.",1368,235,1603
4.9407970905303955,¿Cómo diseñarías un protocolo experimental para evaluar la capacidad de un modelo de PLN en la detección de ambigüedades en textos complejos?,"Para diseñar un protocolo experimental que evalúe la capacidad de un modelo de Procesamiento del Lenguaje Natural (PLN) en la detección de ambigüedades en textos complejos, se podrían seguir los siguientes pasos:  1. **Selección de Texto**: Elegir un conjunto diverso de textos complejos que contengan ambigüedades frecuentes. Esto incluye frases con significados múltiples, estructuras sintácticas confusas y términos que pueden ser interpretados de varias maneras.  2. **Definición de Ambigüedades**: Clasificar los tipos de ambigüedades que se van a evaluar, como la ambigüedad léxica (palabras con múltiples significados), ambigüedad sintáctica (structuras de oraciones que pueden ser interpretadas de diferentes formas) y ambigüedad semántica (diferentes significados derivados del contexto).  3. **Creación de un Dataset Anotado**: Desarrollar un conjunto de datos en el cual cada ambigüedad en el texto esté claramente anotada, indicando sus posibles interpretaciones. Esto servirá como referencia para evaluar la precisión del modelo.  4. **Implementación del Modelo**: Utilizar un modelo de PLN",2883,256,3139
3.354719877243042,"¿Qué estrategias implementarías para mitigar sesgos en modelos de PLN, considerando la diversidad cultural y lingüística?","Para mitigar sesgos en modelos de procesamiento del lenguaje natural (PLN) considerando la diversidad cultural y lingüística, se pueden implementar varias estrategias:  1. **Diversificación de datos de entrenamiento**: Es importante asegurarse de que los datos de entrenamiento sean representativos de diversas culturas, dialectos y variaciones lingüísticas. Esto ayuda a evitar que el modelo aprenda patrones sesgados o que ignore ciertos grupos lingüísticos.  2. **Análisis y ajuste de sesgos en los datos**: Realizar un análisis exhaustivo de los datos para identificar y corregir sesgos preexistentes. Esto puede incluir la eliminación de ejemplos sesgados o la recolección de datos adicionales que representen adecuadamente a grupos subrepresentados.  3. **Incorporación de heurísticas y reglas lingüísticas**: Combinar técnicas de aprendizaje automático con enfoques basados en reglas que reflejen la diversidad de la lengua y la cultura, de manera que se puedan tener en cuenta las particularidades sintácticas y semánticas de cada contexto.  4. **Evaluación continua y métricas de equidad**: Establecer métricas que evalúen la equidad del modelo, para asegurar que se desempeñe de manera justa frente a diferentes grupos. Esto puede",1445,256,1701
4.76854133605957,¿Cómo abordarías el desafío de la interpretación de sarcasmo e ironía en sistemas de PLN?,"El contexto proporcionado está vacío y no hay información específica para abordar la pregunta sobre cómo interpretar sarcasmo e ironía en sistemas de procesamiento de lenguaje natural (PLN). Por lo tanto, puedo ofrecerte una respuesta general.  Para abordar el desafío de la interpretación de sarcasmo e ironía en sistemas de PLN, es fundamental:  1. **Contexto de la conversación**: Considerar el contexto en el que se producen las interacciones. El sarcasmo a menudo depende de referencias culturales, conocimiento previo y la relación entre los hablantes.  2. **Análisis de sentimientos**: Utilizar modelos de análisis de sentimientos que no solo se enfoquen en palabras individuales, sino que también tomen en cuenta la configuración de las frases y la tonalidad general del mensaje.  3. **Recopilación de datos**: Entrenar modelos de PLN con grandes cantidades de ejemplos de sarcasmo e ironía. Esto implica la recopilación de datos etiquetados que reflejen estas formas de expresión.  4. **Características lingüísticas**: Identificar y analizar características lingüísticas específicas que suelen estar presentes en el sarcasmo e ironía, como el uso de hipérboles, contrastes y el contexto situacional.  5. **Interacción humana**: Integrar",130,256,386
4.8336992263793945,"¿De qué manera integrarías conocimientos externos, como ontologías o knowledge graphs, en un modelo de PLN para mejorar su capacidad inferencial?","Integrar conocimientos externos, como ontologías o knowledge graphs, en un modelo de Procesamiento del Lenguaje Natural (PLN) puede mejorar significativamente su capacidad inferencial. Esto se puede lograr mediante varias estrategias:  1. **Incorporación de ontologías**: Las ontologías proporcionan una estructura formal que define relaciones y categorías en un dominio específico. Al integrar estas estructuras en un modelo de PLN, se puede enriquecer la comprensión semántica del texto, permitiendo al modelo identificar y utilizar correctamente las relaciones entre conceptos. Por ejemplo, si un agente conversacional necesita responder a una consulta sobre ""perros"", puede utilizar la ontología para entender que ""perros"" son un tipo de ""mascotas"" y pueden estar relacionados con ""cuidado"", ""alimentación"", entre otros.  2. **Uso de knowledge graphs**: Los knowledge graphs o gráficos de conocimiento son representaciones de datos que muestran relaciones entre diferentes entidades. Integrar un knowledge graph en un modelo de PLN permite al sistema acceder a información interconectada y contextualizada, facilitando inferencias más complejas. Por ejemplo, si el modelo necesita inferir información sobre una persona mencionada, puede consultar el gráfico para recuperar detalles sobre su profesión, lugar de residencia y otros atributos relevantes",2836,256,3092
5.25527286529541,¿Qué criterios utilizarías para determinar la calidad de un corpus destinado al entrenamiento de modelos de PLN en dominios especializados?,"Para determinar la calidad de un corpus destinado al entrenamiento de modelos de PLN en dominios especializados, se pueden considerar los siguientes criterios:  1. **Representatividad**: El corpus debe ser representativo del lenguaje y las características del dominio específico en el que se va a aplicar. Esto implica que los textos incluidos deben reflejar el vocabulario, las expresiones y el estilo que se utilizan comúnmente en ese dominio.  2. **Tamaño**: Un corpus más grande generalmente proporciona más información y ayuda a los modelos a aprender patrones más robustos. Sin embargo, también es importante que este tamaño no comprometa la calidad de los datos.  3. **Anotación**: La calidad de las anotaciones es crucial, especialmente si se trata de un corpus anotado. Una anotación precisa y consistente en aspectos como la sintaxis, semántica y etiquetas morfosintácticas es fundamental para el aprendizaje supervisado y el análisis posterior (pág. 23).  4. **Diversidad**: Debe haber diversidad en los tipos de textos incluidos. Esto puede abarcar diferentes fuentes, formatos y contextos dentro del dominio, lo que ayuda a que el modelo sea más generalizable.  5. **Actualización**: La relevancia del corpus también depende",1368,256,1624
4.189689636230469,¿Cómo justificarías la elección de una arquitectura Transformer frente a otras alternativas en un proyecto de PLN avanzado?,"Parece que no hay contexto proporcionado para responder a la pregunta sobre la elección de una arquitectura Transformer en comparación con otras alternativas en un proyecto de Procesamiento de Lenguaje Natural (PLN) avanzado. Sin información adicional, no puedo justificar la elección de manera específica.  Sin embargo, en términos generales, se podría argumentar que la arquitectura Transformer ofrece varias ventajas significativas, como:  1. **Mecanismo de atención**: Permite captar relaciones de largo alcance en los textos, lo que es esencial en tareas complejas de PLN.     2. **Paralelización**: A diferencia de las arquitecturas recurrentes, los Transformers permiten el procesamiento paralelo de datos, lo que acelera el entrenamiento y la inferencia.  3. **Escalabilidad**: Los Transformers se pueden escalar ampliamente con grandes cantidades de datos y parámetros, lo que ha llevado al desarrollo de modelos de gran tamaño como BERT y GPT.  4. **Transferencia de aprendizaje**: La arquitectura Transformer ha demostrado ser efectiva en tareas de transferencia de aprendizaje, permitiendo que un modelo preentrenado se ajuste a tareas específicas con un conjunto de datos más pequeño.  Si necesitas información más específica o ejemplos concretos, por favor proporciona el contexto necesario, y estaré encantado de",131,256,387
6.3929877281188965,¿Qué medidas tomarías para asegurar la escalabilidad y sostenibilidad en el entrenamiento de modelos de PLN a gran escala?,"Para asegurar la escalabilidad y sostenibilidad en el entrenamiento de modelos de Procesamiento del Lenguaje Natural (PLN) a gran escala, se pueden considerar las siguientes medidas:  1. **Uso de algoritmos eficientes**: Implementar algoritmos de aprendizaje no supervisado que requieren menos datos anotados, lo que permitirá aprovechar grandes volúmenes de datos sin la carga de anotación manual (página 23).  2. **Infraestructura escalable**: Aprovechar la velocidad y capacidad de memoria creciente de los ordenadores. Esto es esencial para manejar el procesamiento intensivo que demandan los modelos de PLN modernos, facilitando su explotación comercial (páginas 21).  3. **Recursos computacionales en la nube**: Utilizar plataformas de computación en la nube para escalar recursos de hardware según sea necesario, permitiendo ejecutar modelos más complejos sin los límites físicos de infraestructura local.  4. **Optimización de modelos**: Implementar prácticas de evaluación basadas en datos que incluyen métricas cuantitativas para evaluar y comparar el rendimiento de distintos modelos, lo que permitirá elegir las configuraciones más efectivas (página 21).  5. **Automatización de procesos**: Integrar técnicas de PLN en tareas específicas (como la crib",1368,256,1624
5.623596668243408,"¿Cómo evaluarías la capacidad de un modelo de PLN para adaptarse a cambios rápidos en el uso del lenguaje, como la aparición de nuevos modismos?","Para evaluar la capacidad de un modelo de procesamiento del lenguaje natural (PLN) para adaptarse a cambios rápidos en el uso del lenguaje, como la aparición de nuevos modismos, es fundamental considerar varios factores. En primer lugar, deberíamos analizar la flexibilidad del modelo en su entrenamiento. Un modelo que utiliza técnicas de aprendizaje no supervisado puede adaptarse mejor a nuevas tendencias lingüísticas, ya que no depende de un corpus anotado fijo. Como se menciona en el contexto, ""a partir de 2005 aparece una nueva tendencia hacia el uso de técnicas de aprendizaje no supervisado en el procesamiento del lenguaje natural"" (Página 23), lo que permite construir aplicaciones lingüísticas que se adapten a datos sin anotación alguna.  Además, es importante evaluar si el modelo incorpora actualizaciones regulares y si se entrena continuamente con datos recientes. Esto permitirá que el modelo reconozca y se adapte a los cambios en el lenguaje, incluyendo la velocidad de la evolución de nuevos modismos. La diversidad del corpus de datos también jugará un papel crucial en la capacidad del modelo para generalizar y entender las nuevas expresiones.  Por último, los mecanismos de evaluación del rendimiento del modelo deben estar orientados a medir su capacidad de adaptación y comprensión del lenguaje actual, considerando también",2905,256,3161
4.5096986293792725,¿Qué metodología propondrías para combinar modelos generativos y discriminativos en una arquitectura híbrida de PLN?,"Para combinar modelos generativos y discriminativos en una arquitectura híbrida de Procesamiento del Lenguaje Natural (PLN), propongo la siguiente metodología:  1. **Definición de Tareas y Componentes**: Primero, es esencial definir claramente las tareas específicas que se quieren abordar, como análisis de sentimientos, etiquetado de partes de discurso, o traducción automática. Esto permitirá seleccionar los modelos generativos y discriminativos más apropiados para cada tarea.  2. **Entrenamiento de Modelos Generativos**: Utilizar un modelo generativo (como un modelo de lenguaje basado en redes neuronales) para capturar la estructura y las distribuciones de los datos de entrada. Los modelos generativos pueden ser efectivos para la generación de texto y para entender el contexto a partir del cual se puede producir información relevante.  3. **Entrenamiento de Modelos Discriminativos**: Paralelamente, se debe entrenar un modelo discriminativo (como una red neuronal o un árbol de decisión) que se especialice en tareas de clasificación o etiquetado, utilizando los mismos datos. Este modelo aprenderá a diferenciar entre diferentes clases en función de las representaciones proporcionadas por el modelo generativo.  4. **Fusión de Representaciones**: En",1444,256,1700
3.6337509155273438,¿Cómo analizarías críticamente la eficacia de las métricas tradicionales en la evaluación de la generación automática de lenguaje?,"Para analizar críticamente la eficacia de las métricas tradicionales en la evaluación de la generación automática de lenguaje, es fundamental considerar varios aspectos.  Primero, las métricas tradicionales, como BLEU, ROUGE y METEOR, han sido ampliamente utilizadas para evaluar la calidad de la generación del lenguaje automático, especialmente en tareas como la traducción automática y la resúmenes de texto. Estas métricas suelen centrarse en la coincidencia de n-gramas entre el texto generado y las referencias humanas, lo cual proporciona una medida cuantitativa del rendimiento del sistema (Archivo: 1-Tema.pdf, página 21). Sin embargo, estas métricas tienen limitaciones significativas.  Una de las principales críticas es que no capturan aspectos semánticos y contextuales del lenguaje. Por ejemplo, dos frases pueden ser semánticamente equivalentes pero tener diferencias léxicas que podrían resultar en una baja puntuación en métricas basadas en coincidencias de n-gramas. Esto sugiere que, aunque un modelo pueda generar texto que es razonablemente bueno en términos de forma, puede que no lo sea en términos de significado, lo cual es crucial para la generación de lenguaje natural (Archivo: 1-Tema.pdf, página 21).  Además, las",3833,256,4089
3.726080894470215,¿Qué desafíos técnicos y éticos se deben considerar al implementar PLN en sistemas de moderación de contenido en redes sociales?,"El contexto proporcionado no aborda directamente los desafíos técnicos y éticos de implementar Procesamiento del Lenguaje Natural (PLN) en sistemas de moderación de contenido en redes sociales. Sin embargo, se puede inferir que al aplicar técnicas de PLN en este ámbito, se deben considerar varios aspectos.  **Desafíos técnicos:** 1. **Análisis de grandes volúmenes de datos:** Las redes sociales generan un volumen masivo de datos en tiempo real, lo que requiere robustas capacidades de procesamiento para analizar el contenido de manera efectiva. 2. **Diversidad del lenguaje:** El lenguaje en redes sociales es muy variado e incluye diferentes jergas, modismos y expresiones culturales, lo que puede dificultar el análisis semántico preciso. 3. **Contextualización:** La necesidad de mantener el contexto y el estado de la conversación es fundamental para entender correctamente las intenciones detrás de un mensaje.  **Desafíos éticos:** 1. **Privacidad de los usuarios:** La recopilación y análisis de datos de los usuarios deben llevarse a cabo con cuidado para no vulnerar su privacidad. 2. **Sesgos en los algoritmos:** Existen preocupaciones sobre cómo los sesgos en el entrenamiento de modelos de PLN pueden llevar a decisiones injust",884,256,1140
3.816436767578125,¿Cómo abordarías el problema de la privacidad y protección de datos en el entrenamiento de modelos de PLN con información sensible?,"Para abordar el problema de la privacidad y protección de datos en el entrenamiento de modelos de Procesamiento de Lenguaje Natural (PLN) con información sensible, se pueden considerar varias estrategias clave:  1. **Anonimización de Datos**: Es fundamental eliminar cualquier información que pueda identificar a individuos. Esto incluye nombres, direcciones y cualquier otro dato personal que pueda asociarse directamente con una persona.  2. **Consentimiento Informado**: Se debe asegurar que los datos utilizados para el entrenamiento han sido recolectados con el consentimiento explícito de los usuarios, dejando claro el uso que se dará a sus datos.  3. **Encriptación**: Implementar métodos de encriptación tanto durante la transmisión como en el almacenamiento de datos sensibles, para proteger la información de accesos no autorizados.  4. **Acceso Restringido**: Limitar el acceso a los datos sensibles solo a personal autorizado y asegurar que se sigan protocolos adecuados de seguridad.  5. **Uso de Datos Sintéticos**: En lugar de utilizar datos reales, se pueden generar datos sintéticos que imiten las características de los datos reales sin comprometer la privacidad.  6. **Cumplimiento Normativo**: Seguir normativas como el Reglamento General de Protección de Datos (RG",410,256,666
2.841505765914917,¿Qué papel crees que jugará la convergencia de hardware avanzado y algoritmos innovadores en el futuro del PLN?,"La convergencia de hardware avanzado y algoritmos innovadores jugará un papel crucial en el futuro del Procesamiento del Lenguaje Natural (PLN). Con la mejora en la capacidad de procesamiento y almacenamiento de datos que ofrece el hardware avanzado, será posible manejar conjuntos de datos masivos y complejos, permitiendo que los algoritmos de aprendizaje automático, tanto supervisados como no supervisados, se desarrollen de manera más efectiva. Esto facilitará la creación de aplicaciones lingüísticas más sofisticadas, como la traducción automática y el etiquetado semántico, que requieren un procesamiento intensivo de datos. Además, la interacción más seria entre lingüistas computacionales y la comunidad estadística, impulsada por estos avances, puede llevar a la innovación en técnicas de análisis de texto y modelos lingüísticos, mejorando así la precisión y la eficiencia de las soluciones de PLN aplicadas a diversos sectores, como los Recursos Humanos y la medicina.",984,190,1174
3.724205732345581,¿Cómo diseñarías un sistema de retroalimentación continua para mejorar el desempeño de un modelo de PLN desplegado en producción?,"Para diseñar un sistema de retroalimentación continua que mejore el desempeño de un modelo de Procesamiento del Lenguaje Natural (PLN) desplegado en producción, se pueden seguir varios pasos:  1. **Recopilación de Datos**: Implementar un mecanismo para recopilar datos de entrada y salida del modelo en tiempo real. Esto incluye ejemplos de texto procesado, resultados de análisis y cualquier error detectado por los usuarios o por el sistema mismo.  2. **Análisis de Errores**: Establecer un sistema para analizar los errores y las limitaciones del modelo. Esto podría incluir la identificación de casos específicos en los que el modelo no produjo resultados precisos o relevantes.  3. **Anotación de Datos**: A medida que se recopilan nuevos datos, es esencial contar con un proceso de anotación que clasifique y explique estos ejemplos, especialmente los que representan situaciones problemáticas.  4. **Retroalimentación de Usuarios**: Incorporar un mecanismo que permita a los usuarios dar retroalimentación sobre los resultados del modelo. Esta retroalimentación puede proporcionar información valiosa sobre cómo se perciben los resultados en la práctica.  5. **Actualización del Modelo**: Utilizar los nuevos datos anotados y la retroalimentación",1370,256,1626
3.6279895305633545,"¿Qué estrategias utilizarías para asegurar la interpretabilidad de decisiones en modelos complejos de PLN en aplicaciones críticas, como la asistencia médica?","Para asegurar la interpretabilidad de decisiones en modelos complejos de Procesamiento del Lenguaje Natural (PLN) en aplicaciones críticas como la asistencia médica, se pueden considerar las siguientes estrategias:  1. **Modelos Transparentes**: Utilizar modelos que sean inherentemente más interpretables, como los modelos de regresión logística o los árboles de decisión, en lugar de los modelos de ""caja negra"" como las redes neuronales profundas. Esto facilita la comprensión de cómo se toman las decisiones.  2. **Explicaciones Post-hoc**: Implementar técnicas de explicación que proporcionen entendimiento sobre las decisiones de modelos complejos. Métodos como LIME (Local Interpretable Model-agnostic Explanations) o SHAP (SHapley Additive exPlanations) pueden ayudar a entender la contribución de cada característica en la predicción.  3. **Visualización de Datos**: Utilizar herramientas de visualización de datos para identificar patrones y relaciones dentro de los datos que el modelo ha considerado. Esto puede incluir gráficos que muestran la importancia de las diferentes características en las decisiones tomadas.  4. **Evaluación de Modelos**: Desarrollar y aplicar métricas cuantitativas para evaluar la interpretabilidad y la transparencia de los modelos utilizados.",1733,256,1989
3.778697967529297,¿Cómo evaluarías la efectividad de un modelo de PLN en la generación de textos coherentes y contextualmente relevantes en entornos con alta variabilidad temática?,"Para evaluar la efectividad de un modelo de procesamiento de lenguaje natural (PLN) en la generación de textos coherentes y contextualmente relevantes en entornos con alta variabilidad temática, se pueden considerar varios enfoques:  1. **Pruebas de Coherencia**: Realizar análisis de coherencia mediante métricas que evalúen la fluidez y la conexión lógica entre las ideas presentadas en el texto generado.  2. **Evaluación Contextual**: Emplear evaluadores humanos para verificar si el modelo puede mantener el contexto relevante y adaptarse a diferentes temas. Esto implica analizar si el modelo somete adecuadamente las variaciones temáticas y produce contenido pertinente.  3. **Métricas Automáticas**: Utilizar métricas automatizadas como BLEU, ROUGE o METEOR, que ayudan a comparar la calidad del texto generado con textos de referencia, así como la habilidad del modelo para capturar la variabilidad temática.  4. **Pruebas de Robustez**: Evaluar cómo el modelo responde a inputs diversos y a cambios abruptos en el tema, lo que puede incluir la presentación de prompts con palabras clave diferentes o en contextos contrastantes.  5. **Análisis de Selección de Palabras**: Analizar",2927,256,3183
4.319904327392578,¿Qué consideraciones metodológicas tomarías en cuenta para investigar la influencia de diferentes técnicas de preprocesamiento en el rendimiento final de un modelo de PLN?,"Para investigar la influencia de diferentes técnicas de preprocesamiento en el rendimiento final de un modelo de PLN, se deben considerar las siguientes metodologías:  1. **Definición clara de objetivos**: Es fundamental establecer qué variables se van a evaluar y cómo se relacionan con el rendimiento del modelo. Definir si se medirá la precisión, la recuperación, o alguna combinación de métricas de evaluación.  2. **Selección de técnicas de preprocesamiento**: Identificar y seleccionar distintas técnicas de preprocesamiento que se alineen con los objetivos de la investigación. Esto puede incluir normalización de textos, eliminación de stop words, lematización o stemming, y tokenización, entre otros.  3. **Construcción de un corpus adecuado**: Utilizar un corpus representativo que contenga una diversidad de ejemplos pertinentes a la tarea de PLN que se esté evaluando. Este corpus deberá ser anotado si es necesario, pues la calidad de los datos influye directamente en el rendimiento del modelo.  4. **Diseño experimental**: Implementar un diseño que permita comparar el rendimiento del modelo bajo diferentes condiciones de preprocesamiento. Por ejemplo, los modelos pueden ser evaluados en ciclos, donde cada ciclo aplica una técnica diferente de preprocesamiento y mide el impacto",1833,256,2089
4.558505058288574,"¿Cómo abordarías el reto de crear modelos de PLN para idiomas con recursos limitados, garantizando una buena calidad en las aplicaciones?","Para abordar el reto de crear modelos de PLN para idiomas con recursos limitados y garantizar una buena calidad en las aplicaciones, se pueden considerar varias estrategias:  1. **Uso de técnicas de aprendizaje no supervisado**: Dado que la producción de corpus anotados para idiomas con recursos limitados puede ser costosa y complicada, se pueden aplicar técnicas de aprendizaje no supervisado. Estas técnicas permiten construir aplicaciones lingüísticas sin la necesidad de datos anotados, lo que es especialmente útil en estos casos (Página 23).  2. **Transferencia de conocimiento de idiomas con recursos abundantes**: Una estrategia efectiva es utilizar modelos preentrenados de idiomas con abundantes recursos y adaptarlos o transferir su conocimiento a idiomas menos representados. Esto puede involucrar técnicas de fine-tuning o ajuste fino para adaptar el modelo a un nuevo idioma.  3. **Colaboración con comunidades lingüísticas**: Al trabajar con hablantes nativos y lingüistas de la lengua objetivo, es posible recoger datos y obtener retroalimentación sobre el uso más efectivo del lenguaje en el contexto cultural de la lengua, lo cual puede ayudar a desarrollar mejores modelos de PLN.  4. **Crowdsourcing**: Involucrar a la comunidad a través de plataformas de crowdsourcing puede facilitar la",2576,256,2832
4.164961814880371,"¿Qué impacto tendría la integración de sistemas multimodales (texto, imagen, audio) en la precisión y utilidad de aplicaciones basadas en PLN?","La integración de sistemas multimodales, que combinarían texto, imagen y audio, podría tener un impacto significativo en la precisión y utilidad de las aplicaciones basadas en Procesamiento del Lenguaje Natural (PLN). Al incorporar diferentes modalidades, estas aplicaciones podrían beneficiarse de un contexto más rico y variado, permitiendo una mejor interpretación y análisis de datos. Por ejemplo, en tareas como la traducción automática o los agentes conversacionales, la capacidad de comprender el contexto visual y auditivo junto con el texto permitiría respuestas más precisas y relevantes, mejorando la comunicación y la interacción.  Además, el uso de técnicas de PLN en aplicaciones como la criba curricular en Recursos Humanos, que se mencionó al analizar grandes volúmenes de currículos, podría ser aún más efectivo si se consideran elementos visuales y auditivos de las candidaturas, enriqueciendo la evaluación de los perfiles de los candidatos (Archivo: 1-Tema.pdf, Página 12).  En resumen, la integración de sistemas multimodales podría mejorar la eficiencia y efectividad del PLN, haciéndolo más robusto frente a la diversidad de contextos y formatos en los que se presenta la información. Esta evolución representaría un avance importante en el desarrollo de modelos de aprendizaje, ya que se adapt",1795,256,2051
4.950394868850708,¿Cómo propondrías medir el impacto real de un modelo de PLN en la mejora de procesos educativos y en la atención a estudiantes?,"Para medir el impacto real de un modelo de Procesamiento del Lenguaje Natural (PLN) en la mejora de procesos educativos y en la atención a estudiantes, se podrían considerar las siguientes métricas y enfoques:  1. **Evaluación Cuantitativa de Resultados**: Implementar métricas que permitan medir el rendimiento del modelo en comparación con los métodos tradicionales de atención educativa. Esto incluiría la evaluación del rendimiento académico de los estudiantes antes y después de la implementación del modelo de PLN.  2. **Análisis de Datos de Uso**: Recopilar datos sobre cómo los estudiantes interactúan con el sistema de PLN, tales como la frecuencia de uso, las consultas realizadas y la efectividad de las respuestas proporcionadas. Esto podría ayudar a determinar la aceptación y utilidad del modelo en el entorno educativo.  3. **Encuestas y Retroalimentación**: Realizar encuestas a estudiantes y educadores sobre su experiencia con el sistema de PLN. Preguntas sobre la facilidad de uso, la relevancia de la información proporcionada y el impacto en el aprendizaje, podrían proporcionar información valiosa sobre el impacto del modelo.  4. **Análisis de Correspondencia de Documentos**: Emplear el uso de técnicas de PLN para analizar la alineación entre los materiales",799,256,1055
8.642183303833008,¿Qué desafíos específicos enfrentarías al aplicar modelos de PLN en la traducción de textos con estructuras gramaticales muy distintas y cómo los solucionarías?,"Al aplicar modelos de procesamiento del lenguaje natural (PLN) en la traducción de textos con estructuras gramaticales muy distintas, se enfrentarían varios desafíos específicos. Uno de los problemas principales es la dificultad para comprender el significado de las oraciones y cómo se estructuran en diferentes idiomas. Esto se debe a que los modelos de PLN deben tener un conocimiento profundo del lenguaje, que incluye tanto la sintaxis como la semántica. Por ejemplo, un agente conversacional necesita ""reconocer las palabras de una señal de audio"" y ""generar una señal de audio de una secuencia de palabras"", lo que se complica si las estructuras gramaticales son muy disímiles (Archivo: 1-Tema.pdf, Página 27).  Para abordar este desafío, se pueden emplear enfoques de aprendizaje automático que integren datos anotados y no anotados. Por un lado, los datos anotados pueden ayudar a entrenar modelos de traducción que capturan las diferencias gramaticales específicas. Por otro lado, las técnicas de aprendizaje no supervisado podrían ser útiles para aprender patrones de traducción en grandes volúmenes de texto sin necesidad de que estos datos estén previamente etiquetados (Archivo: 1-Tema.pdf, Página 23",2580,256,2836
4.368407249450684,¿Cómo evaluarías la capacidad de un modelo de PLN para captar y procesar la evolución del lenguaje en redes sociales y medios digitales?,"Para evaluar la capacidad de un modelo de procesamiento del lenguaje natural (PLN) para captar y procesar la evolución del lenguaje en redes sociales y medios digitales, es esencial considerar varios aspectos clave.   En primer lugar, un modelo debe ser capaz de analizar grandes volúmenes de texto generados en plataformas como Twitter, Facebook o Instagram, donde la rapidez y la variabilidad del lenguaje, incluyendo jerga, modismos y abreviaciones, son frecuentes. Esto requiere técnicas efectivas de análisis de sentimientos y clasificación que permitan interpretar correctamente el significado detrás de estos textos.  Además, es crucial que el modelo utilice algoritmos de aprendizaje automático que le permitan adaptarse a los cambios en el lenguaje, dado que las normas y usos del lenguaje en medios digitales pueden evolucionar rápidamente. Esto implica el uso de técnicas de aprendizaje no supervisado para explotar datos sin anotación, haciendo posible que el modelo aprenda de manera eficiente a medida que se producen variaciones lingüísticas (Archivo: 1-Tema.pdf, página 23).  Finalmente, la capacidad de un modelo para mantener el contexto de la conversación y generar respuestas coherentes y relevantes también debe ser evaluada, ya que en las redes sociales la interacción es dinámica y fluida. Esto se relaciona con el conocimiento que",3099,256,3355
3.6634554862976074,¿Qué innovaciones crees que son necesarias para que los modelos de PLN puedan comprender mejor contextos y matices culturales en aplicaciones globales?,"Para que los modelos de procesamiento del lenguaje natural (PLN) puedan comprender mejor los contextos y matices culturales en aplicaciones globales, se podrían considerar las siguientes innovaciones:  1. **Incorporación profunda de datos culturales**: Es crucial que los modelos integren datos que reflejen diversas culturas y sus particularidades lingüísticas y sociales. Esto incluye no solo diferentes lenguas, sino también dialectos, expresiones idiomáticas y referencias culturales que sean específicas a cada región.  2. **Desarrollo de algoritmos adaptativos**: Los modelos deben ser capaces de adaptarse en tiempo real a los cambios culturales y contextuales. Esto podría lograrse a través de técnicas de aprendizaje continuo que permitan a los sistemas actualizar su conocimiento basado en interacciones recientes con los usuarios.  3. **Análisis de sentimientos y emociones contextuales**: Las expresiones de sentimiento varían según los contextos culturales. Por lo tanto, se necesitan modelos que puedan identificar y clasificar emociones de manera más precisa, considerando matices que van más allá de lo literal.  4. **Colaboración interdisciplinaria**: Trabajar en conjunto con antropólogos, sociólogos y linguistas puede enriquecer el desarrollo de modelos más completos en el reconocimiento de normativas culturales y",2755,256,3011
6.0949249267578125,¿Cómo diseñarías un sistema de evaluación que integre tanto métricas cuantitativas como juicios cualitativos para valorar la calidad de la generación automática de lenguaje?,"Para diseñar un sistema de evaluación que integre métricas cuantitativas y juicios cualitativos en la valoración de la calidad de la generación automática de lenguaje, podrías considerar la siguiente estructura:  1. **Métricas Cuantitativas**:     - **Evaluación Basada en Datos**: Utiliza métricas cuantitativas estándar, como la precisión, la recuperación y la F1-score, para medir el rendimiento del modelo en tareas específicas de generación de lenguaje. Estas métricas permitirían una comparación objetiva contra conjuntos de datos de referencia.    - **Métricas de Diversidad**: Incluye mediciones que analicen la diversidad y creatividad en la generación de contenido, tales como el número de palabras únicas o la entropía del texto generado.    - **Métricas de Fluidez y Coherencia**: Implementa algoritmos que calculen la fluidez y coherencia del texto, posiblemente utilizando modelos de lenguaje que puedan puntuar la gramática y la estructura del texto.  2. **Juicios Cualitativos**:    - **Evaluaciones por Expertos**: Recluta a lingüistas y expertos en procesamiento del lenguaje natural que puedan realizar una evaluación cualitativa del texto generado, proporcionando retroaliment",3216,256,3472
4.116261959075928,¿Qué aspectos considerarías esenciales para la sostenibilidad y actualización a largo plazo de modelos de PLN en entornos de rápida evolución tecnológica?,"Para garantizar la sostenibilidad y actualización a largo plazo de los modelos de Procesamiento del Lenguaje Natural (PLN) en entornos de rápida evolución tecnológica, considerar los siguientes aspectos es esencial:  1. **Adopción de Técnicas de Aprendizaje No Supervisado**: Dado que la producción de corpus anotados puede ser costosa y difícil, es fundamental incorporar técnicas de aprendizaje no supervisado. Esto permite construir aplicaciones lingüísticas utilizando datos sin anotación, lo que puede ser crucial para adaptarse a cambios rápidos y grandes volúmenes de datos (Archivo: 1-Tema.pdf, Página 23).  2. **Evolución de Algoritmos y Modelos**: Es importante que los modelos de PLN se actualicen y refinen constantemente mediante la incorporación de nuevos algoritmos que se adapten a los últimos avances en tecnología y en la investigación, así como a las metodologías de evaluación que hayan demostrado ser efectivas (Archivo: 1-Tema.pdf, Página 21).  3. **Integración de Recursos Computacionales**: Aprovechar mejoras en la velocidad y capacidad de los ordenadores puede facilitar la ejecución de modelos más complejos y la gestión de grandes volúmenes de datos, permitiendo la explotación comercial de diferentes áreas de",1371,256,1627
