time(s),question,response,input_Tokens,output_Tokens,Total_Tokens
2.639096260070801,¿Por qué se considera fundamental el estudio del Procesamiento del Lenguaje Natural en la interacción entre humanos y máquinas?,"El estudio del Procesamiento del Lenguaje Natural (PLN) es fundamental en la interacción entre humanos y máquinas porque tiene como objetivo que las máquinas sean capaces de realizar tareas que involucren el lenguaje humano. Esto incluye habilitar a las máquinas para comunicarse con personas, mejorar la comunicación entre humanos y procesar texto o habla. Además, el PLN abarca diversas disciplinas, lo que permite una comprensión integral de cómo se desarrolla esta interacción y cómo se pueden implementar mejoras efectivas en el uso del lenguaje por parte de las máquinas (Archivo: NPL.pdf, Página 6).",2092,117,2209
3.7818708419799805,¿De qué manera el PLN mejora la experiencia del usuario en aplicaciones cotidianas?,"El procesamiento del lenguaje natural (PLN) mejora la experiencia del usuario en aplicaciones cotidianas de diversas maneras. Una de las aplicaciones más destacadas es en el ámbito de Recursos Humanos (RR. HH.), donde el PLN facilita la criba curricular, ayudando a ordenar un gran volumen de currículums según su alineación con la descripción del puesto de trabajo. Esto permite a las empresas identificar más fácilmente a los candidatos que mejor se ajustan a sus necesidades, optimizando así el proceso de selección. Además, el PLN se utiliza en sistemas de análisis de sentimientos, traducción automática, autocompletado de textos y generación de resúmenes, todos estos aspectos contribuyen a que la interacción con aplicaciones sea más fluida y personalizada, mejorando la satisfacción del usuario.  Referencias:  - ""PLN para casos de uso concretos"", NPL.pdf, Página 11. - ""Aplicaciones del PLN"", NPL.pdf, Página 7.",1349,196,1545
4.039768695831299,¿Qué papel juega la tokenización en el análisis de textos?,"La tokenización juega un papel crucial en el análisis de textos, ya que es el primer paso del flujo de normalización que permite descomponer una cadena de texto, como una frase, en sus componentes individuales, es decir, en tokens o palabras. Este proceso facilita la identificación y extracción de palabras, lo que es fundamental para realizar tareas de procesamiento del lenguaje natural (PLN) como el etiquetado morfosintáctico y el análisis de sentimientos.   Al tokenizar, se separa el texto en partes más pequeñas y manejables, lo que permite a los modelos de aprendizaje automático trabajar con estas unidades sin la interferencia de elementos como signos de puntuación o espacios en blanco. Además, este proceso también aborda la normalización de palabras similares o variantes (como conjugaciones verbales), lo que contribuye a una mejor interpretación del significado del texto en su conjunto (Fuente: Procesamiento del Lenguaje Natural, Tema 2. Ideas clave, Página 43).",3617,198,3815
3.031136989593506,¿Por qué es importante contar con un corpus de calidad en el desarrollo de modelos de PLN?,"Contar con un corpus de calidad es crucial en el desarrollo de modelos de procesamiento de lenguaje natural (PLN) debido a que la calidad de los datos de entrenamiento influye directamente en el rendimiento del modelo. La existencia de recursos anotados ha promovido la tendencia de abordar problemas complejos del PLN, como el análisis sintáctico y semántico, mediante enfoques de aprendizaje automático supervisados. Sin embargo, el coste y la dificultad de producir corpus anotados se convirtió en un factor limitante para muchos problemas del procesamiento del lenguaje, lo que llevó a una nueva tendencia hacia el uso de técnicas de aprendizaje no supervisado. Esto resalta cómo un corpus de calidad facilita tanto la creación de modelos precisos como la exploración de diferentes enfoques de aprendizaje, ayudando a avanzar en el campo del PLN.   Referencia: ""Procesamiento del Lenguaje Natural"" (Página 22)",3537,181,3718
3.1387434005737305,¿Cuál es la diferencia fundamental entre stemming y lematización?,"La diferencia fundamental entre stemming y lematización radica en cómo se simplifican las representaciones de las palabras. En el caso de la lematización, se busca representar palabras como ""jugaron"" y ""yo juego"" con el lema ""jugar"", mientras que en el stemming, estas palabras se representan de forma diferente, como ""jug"" y ""jueg"", respectivamente. Un aspecto importante a remarcar es que en el stemming se pueden perder representaciones que deberían ser equivalentes. Además, no siempre es aconsejable llevar a cabo estos procesos de normalización, ya que se puede perder información relevante del texto.   Esto se detalla en el contexto proporcionado en ""Procesamiento del Lenguaje Natural, Tema 5. Ideas clave"" en la página 48.",3795,163,3958
4.8523108959198,¿Cómo se relaciona el análisis sintáctico con la comprensión del lenguaje?,"El análisis sintáctico se relaciona con la comprensión del lenguaje al proporcionar una estructura que permite extraer información sobre las relaciones entre las palabras en una oración. Esto es fundamental para entender el significado de la misma, ya que el análisis sintáctico permite generar un árbol sintáctico que representa estas relaciones estructurales. Este árbol, a su vez, sirve como entrada para el análisis semántico, que es el proceso a través del cual se produce la representación del significado de la oración.  La conexión entre el análisis sintáctico y la comprensión del lenguaje se hace evidente al considerar que el significado de una oración no solo depende de las palabras que la componen, sino también del orden y la agrupación de estas palabras. Esto resalta la importancia de la estructura sintáctica en la interpretación del significado, pues al comprender cómo están organizadas las palabras, se puede desambiguar y clarificar el sentido de la oración (Archivo: NPL.pdf, Página 137).  En resumen, el análisis sintáctico forma la base sobre la cual se realiza el análisis semántico, contribuyendo significativamente a la comprensión integral del lenguaje.",2664,231,2895
2.4568254947662354,¿Qué se entiende por “modelo de lenguaje” y para qué se utiliza?,"Un ""modelo de lenguaje"" se entiende como una distribución de probabilidad sobre las palabras de una secuencia. Se utiliza para predecir qué palabra o palabra podría seguir a una secuencia de palabras dada, basándose en el conocimiento estadístico del lenguaje obtenido de uno o varios corpus de la lengua. Estos modelos están diseñados para ayudar en tareas de procesamiento del lenguaje natural (PLN) al identificar la probabilidad de que una palabra siga a otra, facilitando así la comprensión y generación de texto en lenguaje humano (Archivo: NPL.pdf, Página 199).",3076,116,3192
2.444108247756958,¿Por qué es relevante el análisis de sentimiento en el procesamiento de opiniones y reseñas?,"El análisis de sentimientos es relevante en el procesamiento de opiniones y reseñas porque permite detectar el sentimiento expresado por el autor de un texto hacia un determinado objeto, como un producto o servicio. Esto es crucial para las empresas y consumidores, ya que ayuda a entender las percepciones del público y cómo se sienten hacia ciertos elementos. A través de algoritmos de aprendizaje automático, se puede clasificar automáticamente el sentimiento, ya sea positivo, negativo o neutral, facilitando así la toma de decisiones basada en la retroalimentación del cliente. Esta capacidad de análisis permite a las organizaciones responder de manera más efectiva a las necesidades y expectativas de sus usuarios (NPL.pdf, Página 297).",985,138,1123
4.938124895095825,¿En qué consiste el proceso de normalización del texto y por qué se aplica?,"El proceso de normalización del texto consiste en aplicar una serie de técnicas que permiten transformar un texto en una forma más adecuada para su análisis o procesamiento en tareas de procesamiento del lenguaje natural. Este flujo de normalización incluye varios pasos, siendo el primero la tokenización, que se refiere a descomponer una cadena de texto en sus componentes, como las palabras que la forman.   Durante el proceso de normalización, es importante tratar adecuadamente los distintos elementos del texto, como eliminar signos de puntuación, manejar caracteres especiales y decidir cómo tratar nombres propios y palabras compuestas. La normalización también puede incluir la obtención del lema o raíz de las palabras, que permite representar diferentes formas de una misma palabra con un solo token, facilitando así el análisis. Estas técnicas se utilizan para preparar el texto para ser usado como entrada en modelos de aprendizaje automático, donde la representación adecuada de las variables es crucial para el rendimiento del modelo (Tema 2. Ideas clave, página 17 y 20).  Se aplica la normalización para optimizar el análisis del texto, asegurando que los modelos de PLN puedan trabajar de manera más eficiente al operar sobre datos que han sido sistemáticamente tratados, lo que facilita tareas como clasificación de sentimientos, etiquetado semántico, entre otras (Tema 2. Ideas clave, página 42).",3622,268,3890
5.973630428314209,¿Qué ventajas ofrece el uso de algoritmos de clasificación en el PLN?,"El uso de algoritmos de clasificación en el Procesamiento del Lenguaje Natural (PLN) ofrece varias ventajas, principalmente en la mejora de la precisión y la eficiencia de tareas específicas. Entre estas ventajas se incluyen:  1. **Automatización de procesos**: Los algoritmos de clasificación permiten la automatización de tareas que, de otro modo, requerirían un análisis manual intensivo, como el etiquetado de texto o la criba curricular en Recursos Humanos. Esto puede ser especialmente útil cuando se manejan grandes volúmenes de datos (Página 11, Tema 1. Ideas clave).  2. **Identificación de patrones**: Estos algoritmos pueden identificar patrones complejos en los datos textuales, lo que facilita la clasificación y clasificación de información relevante basada en características aprendidas de los datos de entrenamiento (Página 22, Tema 1. Ideas clave).  3. **Mejora en la toma de decisiones**: Al clasificar textos o datos, se pueden tomar decisiones más informadas y precisas, mejorando así la efectividad en aplicaciones como análisis de sentimientos o sistemas de preguntas y respuestas (Página 281, Tema 9. Ideas clave).  4. **Flexibilidad de aplicación**: Los algoritmos de clasificación pueden adaptarse a diferentes dominios y tipos de datos, lo que los hace aplicables en una amplia variedad de tareas, desde traducción automática hasta recuperación de información (Página 256, Tema 8. Ideas clave).  Estas ventajas reflejan cómo los algoritmos de clasificación son esenciales en el PLN para mejorar la eficiencia y la calidad de las interacciones con datos textuales.",3169,329,3498
4.489211559295654,¿Cómo se utiliza el etiquetado POS (Part-of-Speech) en el procesamiento de textos?,"El etiquetado POS (Part-of-Speech) se utiliza en el procesamiento de textos para identificar las diferentes partes de una oración y asignar una etiqueta a cada palabra según su categoría gramatical. Este proceso se conoce como etiquetado morfosintáctico y consiste en una entrada de secuencia de palabras, de la cual se genera una salida que es una secuencia de pares formados por la palabra y la etiqueta correspondiente. Estas etiquetas corresponden a las categorías gramaticales de cada palabra dentro del texto analizado, permitiendo así una comprensión más estructurada de la información contenida en el mismo (Archivo: NPL.pdf, Página 66).  El etiquetado POS se basa en conjuntos de etiquetas, y hoy en día, muchos algoritmos que procesan palabras en inglés utilizan el Penn Treebank, que contiene un conjunto de 45 etiquetas que identifican diversas partes de la oración (Archivo: NPL.pdf, Página 65).",2612,196,2808
3.765791177749634,¿Qué desafíos presenta la ambigüedad lingüística en la interpretación de textos?,"La ambigüedad lingüística presenta varios desafíos en la interpretación de textos. Uno de los problemas más significativos es la ambigüedad estructural, que se debe a las múltiples reglas representadas en una gramática, derivadas del uso común del lenguaje. Esto permite que se puedan encontrar múltiples resultados del análisis sintáctico que se ajusten correctamente a la oración analizada. Por ejemplo, en la frase ""hombres y mujeres mayores"", puede no estar claro si el adjetivo ""mayores"" se refiere a ambos, hombres y mujeres, o solamente a las mujeres. Esta dificultad requiere que el analizador sintáctico que obtiene esos resultados decida cuál de los árboles sintácticos producir como salida del proceso de análisis (NPL.pdf, Página 99).  Además, la ambigüedad léxica también es un problema relevante, ya que una palabra puede tener varios significados y los algoritmos de desambiguación del sentido deben seleccionar el sentido correcto en función del contexto. Esto puede complicar aún más la comprensión del texto, dado que la selección incorrecta de un significado puede alterar el sentido general de la oración (NPL.pdf, Página 169). En resumen, la ambigüedad lingüística puede dificultar el análisis y la comprensión precisa del lenguaje natural, lo que representa un desafío significativo en el procesamiento del lenguaje natural.",2139,277,2416
9.194737672805786,¿Cómo contribuyen las redes neuronales al avance en el PLN?,"Las redes neuronales han contribuido significativamente al avance en el procesamiento del lenguaje natural (PLN) de diversas maneras. En primer lugar, son esenciales para construir modelos de lenguaje (language models, LM), ya que permiten calcular las probabilidades de que ciertas secuencias de palabras aparezcan juntas en un texto. Esto se logra sin necesidad de considerar todos los elementos de la secuencia, enfocándose solo en los N últimos términos, lo que es una mejora respecto a los modelos estadísticos basados en n-gramas que presentan limitaciones, como la falta de manejo de secuencias no vistas en el corpus de entrenamiento (NPL.pdf, página 243).  Además, las redes neuronales son capaces de realizar representaciones vectoriales del significado de las palabras mediante algoritmos como Skip-gram o CBOW. Esto permite que se construyan embeddings contextuales, mejorando la comprensión y manejo de la información textual (NPL.pdf, página 227). Asimismo, los modelos preentrenados como BERT utilizan arquitecturas de redes neuronales avanzadas, como los transformers, que resuelven problemas presentes en las redes neuronales recurrentes, como la pérdida de información de etapas anteriores y dificulta el procesamiento paralelo (NPL.pdf, página 256).   En definitiva, las redes neuronales han permitido un manejo más eficiente y eficaz de las tareas complejas del PLN, desde la traducción automática hasta el análisis de sentimientos, promoviendo avances significativos en la capacidad de las máquinas para comprender y procesar el lenguaje humano (NPL.pdf, página 281).",3357,320,3677
3.902946710586548,¿Qué es la generación de lenguaje natural (NLG) y cuál es su aplicación práctica?,"La generación de lenguaje natural (NLG) se refiere al proceso mediante el cual las máquinas producen texto en un lenguaje humano comprensible a partir de datos estructurados. Esta técnica es parte del procesamiento del lenguaje natural (PLN) y permite a las computadoras traducir información y datos en narrativas o descripciones que tienen sentido para los humanos.  Una de las aplicaciones prácticas más comunes de la NLG es en la automatización de informes, donde se generan resúmenes o análisis a partir de conjuntos de datos, como informes financieros, análisis deportivos o resultados de encuestas. También se utiliza en chatbots y asistentes virtuales que responden preguntas o interactúan con los usuarios en un formato conversacional.  No se proporciona información específica sobre NLG en el contexto citado, pero se vincula al procesamiento del lenguaje natural como una de sus aplicaciones más destacadas, lo que implica que es un área relevante dentro de las tareas que involucran el lenguaje humano.",2733,194,2927
5.511036396026611,¿De qué manera la segmentación de oraciones facilita el análisis textual?,"La segmentación de oraciones, que se lleva a cabo a través de la tokenización, facilita el análisis textual al descomponer una cadena de texto en sus términos o componentes, como las palabras que la forman. Este proceso es esencial para obtener la construcción del significado de un texto desde sus elementos y, además, es un paso habitual en el procesamiento del lenguaje natural (PLN). Al transformar un texto en sus componentes, se pueden extraer variables que serán utilizadas como entrada en modelos de aprendizaje automático, como en el análisis del sentimiento de un texto (Archivo: NPL.pdf, Página 42).  La tokenización permite que el análisis morfológico y sintáctico se realice de manera más eficiente, ya que proporciona las unidades básicas sobre las que se opera. Sin la segmentación adecuada, sería más difícil identificar y analizar las relaciones gramaticales y semánticas en el texto, lo que podría llevar a una interpretación errónea o incompleta del significado (Archivo: NPL.pdf, Página 87).",3298,209,3507
3.8886146545410156,¿Qué importancia tiene la detección de entidades en el PLN?,"La detección de entidades en el Procesamiento del Lenguaje Natural (PLN) es crucial porque permite identificar y clasificar elementos clave en un texto, como nombres de personas, lugares, organizaciones, fechas, entre otros. Esto facilita la comprensión y el análisis de la información contenida en textos, siendo fundamental para tareas como la recuperación de información, el análisis semántico y la mejora de la interacción hombre-máquina. Además, permite automatizar procesos como la criba curricular en Recursos Humanos, donde se puede analizar y clasificar currículums de forma más eficiente si son muchos (Tema 1, Página 11).  Aunque el contexto específico sobre la detección de entidades no se menciona directamente en el material proporcionado, se infiere su importancia de los ejemplos de aplicaciones de PLN, donde se resalta la necesidad de entender y organizar la información relevante en grandes volúmenes de texto. Esto se relaciona estrechamente con la identificación y clasificación de entidades dentro de esos textos, mostrando su relevancia en la efectividad del PLN.",3307,213,3520
3.4882333278656006,¿Cómo se puede utilizar el PLN en el área de la atención al cliente?,"El procesamiento del lenguaje natural (PLN) se puede utilizar en el área de la atención al cliente mediante la implementación de sistemas de Question Answering, que buscan responder a las consultas de los usuarios basándose en la información disponible en una colección de documentos. Además, el PLN puede facilitar la automatización de respuestas a preguntas frecuentes a través de chatbots, mejorando la eficiencia y rapidez en la atención al cliente. Estas herramientas permiten manejar un gran volumen de interacciones de manera más efectiva, aliviando la carga de trabajo de los agentes humanos y proporcionando respuestas instantáneas a los clientes.  Referencia: ""Aplicaciones del PLN"", Página 281.",2729,132,2861
5.865467309951782,¿Qué es el análisis de dependencias y cómo ayuda en la comprensión de una oración?,"El análisis de dependencias, también conocido como gramáticas valenciales, modela las dependencias entre los elementos léxicos de una oración, lo que significa que describe la estructura sintáctica en términos de las palabras que la componen y las relaciones gramaticales entre ellas. A diferencia de las gramáticas de estructura sintagmática, que se centran en los constituyentes sintácticos, las gramáticas de dependencias se enfocan exclusivamente en cómo las palabras se relacionan entre sí.  Este tipo de análisis ayuda en la comprensión de una oración al proporcionar una representación clara de cómo se conectan las palabras entre sí, lo que permite identificar la función gramatical de cada palabra en la oración y, por ende, mejorar la interpretación del significado global del enunciado. Por ejemplo, al analizar la oración “Prefiero un vuelo a través de Denver por la mañana”, el análisis de dependencias revela la relación entre el verbo “prefiero” y su complemento, así como otras relaciones pertinentes entre los elementos.  Referencias:  - Procesamiento del Lenguaje Natural, Tema 9. Ideas clave, Página 121. - Procesamiento del Lenguaje Natural, Tema 4. Ideas clave, Página 137.",3352,251,3603
4.378445148468018,¿En qué consiste el aprendizaje supervisado en el contexto del PLN?,"El aprendizaje supervisado en el contexto del Procesamiento del Lenguaje Natural (PLN) consiste en utilizar un conjunto de instancias etiquetadas para entrenar un clasificador. Este clasificador, una vez entrenado, predice el mejor sentido de las palabras ambiguas en un contexto determinado. En la implementación de algoritmos de aprendizaje supervisado, se puede partir de un conjunto de palabras ambiguas, preseleccionando un subconjunto de sentidos posibles y etiquetando manualmente ejemplos de su aparición en un corpus. Esto permite entrenar un modelo que sirve para desambiguar palabras en un texto.  Además, se puede utilizar un corpus de palabras ya etiquetadas para aprender a desambiguar todas las palabras de un texto, no solo un conjunto reducido. Esto se conoce como una segunda opción de implementación del aprendizaje supervisado, donde el modelo se entrena en un contexto más amplio.   (Referencia: ""Desambiguación basada en aprendizaje supervisado"", página 171)",3197,200,3397
3.246764659881592,¿Qué papel juega el preprocesamiento en el rendimiento de un modelo de PLN?,"El preprocesamiento juega un papel crucial en el rendimiento de un modelo de PLN porque permite limpiar y preparar los datos de texto para su posterior análisis y entrenamiento. Este paso es fundamental para mejorar la calidad de los datos, eliminar ruidos y normalizar la información, lo cual optimiza el aprendizaje del modelo. Los datos preprocesados tienden a ser más coherentes y relevantes, lo que a su vez permite al modelo hacer mejores predicciones y clasificaciones. Sin un adecuado preprocesamiento, el modelo puede ser menos efectivo y producir resultados inexactos.  Esta idea se alinea con lo discutido en el contexto, donde se menciona que la calidad de los datos de entrada es un factor determinante en el procesamiento del lenguaje natural y en el funcionamiento de aplicaciones avanzadas como agentes conversacionales, sistemas de traducción automática y otros sistemas de búsqueda de respuestas (Archivo: NPL.pdf, Página 24).",3327,186,3513
2.6845388412475586,¿Cómo se aplica el PLN en sistemas de traducción automática?,"El PLN se aplica en los sistemas de traducción automática (Machine Translation, MT) para generar automáticamente la traducción de un texto de un idioma a otro. Este proceso no solo implica la conversión de palabras individuales a su equivalente en otra lengua, sino que debe considerar toda la información de la secuencia del texto para realizar una traducción precisa. Esto se debe a que existen divergencias en el idioma que pueden afectar tanto a palabras concretas (aspectos léxicos) como a la estructura de las frases (orden de los verbos, objetos directos, etc.). Por lo tanto, es crucial tener en cuenta el contexto y la estructura completa de las oraciones para realizar una traducción efectiva (Procesamiento del Lenguaje Natural, página 283).",2985,154,3139
3.1648080348968506,¿Por qué es necesario actualizar y mejorar constantemente los corpus utilizados en el PLN?,"Es necesario actualizar y mejorar constantemente los corpus utilizados en el Procesamiento del Lenguaje Natural (PLN) debido a que el coste y la dificultad de producir corpus anotados se convierte en un factor limitante del uso de enfoques supervisados para muchos problemas del procesamiento del lenguaje. Este contexto llevó a un cambio hacia el uso de técnicas de aprendizaje no supervisado, permitiendo la construcción de aplicaciones lingüísticas a partir de datos sin anotación, como por ejemplo, para la traducción automática o para el modelado de temas. Esto indica que la evolución y relevancia de los datos son fundamentales para el desarrollo efectivo de modelos en PLN.  Referencia: ""Procesamiento del Lenguaje Natural, Tema 1. Ideas clave, Página 22"".",3216,150,3366
4.118106842041016,¿Qué retos presenta el manejo de lenguaje coloquial o regional en el PLN?,"El manejo de lenguaje coloquial o regional en el procesamiento del lenguaje natural (PLN) presenta varios retos, entre los cuales se incluyen la variedad de expresiones, jerga y modismos que pueden ser muy diferentes dependiendo de la región o el contexto sociocultural. Esto puede dificultar la comprensión y el análisis automático de textos, ya que los sistemas de PLN deben ser entrenados para reconocer y gestionar estas variaciones.  Además, las formas coloquiales del lenguaje suelen incluir errores gramaticales, abreviaciones y formas no estándar de palabras, lo que complicaría aún más el proceso de análisis. La diversidad y evolución constante del lenguaje coloquial también significa que los modelos deben ser actualizados con frecuencia para mantenerse relevantes.  Si bien el contenido específico sobre los retos del lenguaje coloquial o regional no se extrajo directamente de las páginas proporcionadas, el contexto general del PLN sugiere que la combinación de la rica variedad lingüística y los cambios constantes en el uso del lenguaje podrían ser decisivos en el desarrollo de modelos robustos y efectivos (ver ""Índice"", página 2; ""Procesamiento del lenguaje natural"", página 5).",2065,233,2298
7.659192800521851,¿Cómo influye el tamaño del corpus en la capacidad de un modelo de PLN?,"El tamaño del corpus influye significativamente en la capacidad de un modelo de Procesamiento del Lenguaje Natural (PLN) porque un corpus más grande y diverso proporciona una mayor cantidad de datos para que el modelo aprenda, lo que a su vez mejora su capacidad para generalizar y manejar variaciones en el lenguaje. Cuando se entrena un modelo de lenguaje, como los basados en n-gramas, la probabilidad de que se reconozcan secuencias correctas aumenta con información más amplia y representativa de diferentes contextos y usos del lenguaje. Por ende, un corpus mayor puede reducir la perplejidad y mejorar la precisión en tareas específicas de PLN. Esto es especialmente relevante en modelos que se basan en algoritmos de aprendizaje automático, donde la calidad y cantidad de datos de entrenamiento son factores críticos para el rendimiento del modelo.  Esto se puede observar en la sección sobre modelado del lenguaje que menciona: ""el conjunto de datos original también se podría separar en entrenamiento/validación/test si se quiere tener un subconjunto para hacer validaciones iniciales y ajustar parámetros"" (Archivo: NPL.pdf, Página 205). Además, al hablar de modelos de representación vectorial, destaca que ""al ser vectores dentro de un mismo espacio vectorial, los documentos con un contenido similar al de la consulta deberían tener vectores similares"" (Archivo: NPL.pdf, Página 216).",2172,285,2457
7.209852457046509,¿Qué beneficios se obtienen al integrar técnicas de PLN en sistemas educativos?,"La integración de técnicas de procesamiento del lenguaje natural (PLN) en sistemas educativos proporciona varios beneficios significativos:  1. **Personalización del Aprendizaje**: Las técnicas de PLN pueden adaptar el contenido educativo a las necesidades individuales de cada estudiante, facilitando un aprendizaje más personalizado y efectivo.  2. **Análisis de Sentimientos y Feedback**: Los sistemas de PLN pueden ser utilizados para analizar las opiniones y sentimientos de los estudiantes sobre el contenido del curso, permitiendo ajustes en tiempo real para mejorar la experiencia de aprendizaje.  3. **Automatización de Tareas Administrativas**: Las herramientas de PLN pueden automatizar tareas como la revisión de trabajos y la evaluación de pruebas, liberando tiempo para que los educadores se concentren en otros aspectos del proceso educativo.  4. **Facilitación de la Accesibilidad**: El PLN puede mejorar la accesibilidad al contenido educativo mediante la generación automática de resúmenes, la síntesis de texto o la traducción, lo cual es útil para estudiantes de diferentes niveles y antecedentes lingüísticos.  5. **Interacción Mejorada**: Herramientas como los chatbots basados en PLN pueden proporcionar a los estudiantes respuestas instantáneas a sus preguntas, fomentando una interacción más activa y continua.  6. **Desarrollo de Habilidades Lingüísticas**: Al implementar sistemas de autocompletado y corrección automática, los estudiantes pueden mejorar sus habilidades de escritura y lenguaje, recibiendo retroalimentación inmediata.  Estos beneficios muestran cómo el PLN puede transformar y enriquecer la experiencia educativa, haciéndola más eficiente y accesible para todos los estudiantes.  Para más detalles sobre las aplicaciones del PLN en contextos educativos, puedes consultar el documento ""Procesamiento del Lenguaje Natural"" en la página 7 y la página 288, donde se habla de aplicaciones industriales y del impacto del PLN en la educación.",3115,380,3495
3.9474194049835205,¿Cómo influye el proceso de preprocesamiento en la calidad del análisis de textos en PLN?,"El proceso de preprocesamiento es fundamental en el análisis de textos en PLN, ya que establece las bases para que las aplicaciones de procesamiento del lenguaje natural puedan trabajar de manera eficaz con los datos de texto. En este sentido, el preprocesamiento incluye técnicas de normalización que permiten estructurar y limpiar los datos, facilitando su análisis posterior.  Por ejemplo, la normalización de textos ayuda a manejar las diversas variaciones del lenguaje, como acentos, sinónimos, y formas gramaticales diferentes, asegurando que el sistema pueda interpretar correctamente el contenido. Esta fase es esencial porque un texto bien preprocesado puede mejorar significativamente el rendimiento de modelos de PLN, ya que minimiza el ruido y permite que el enfoque se dirija a las características más relevantes del texto.  En resumen, un adecuado preprocesamiento no solo optimiza la calidad de los datos, sino que también influye directamente en la precisión y eficacia de los resultados obtenidos en análisis de textos, como en la clasificación de sentimientos o la generación de resúmenes.   (Referido desde el contexto: ""Objetivos"", Página 33)",3139,227,3366
6.229248285293579,¿Qué implicaciones tiene el uso de técnicas de embeddings en comparación con representaciones tradicionales como bag-of-words?,"El uso de técnicas de embeddings, como Word Embeddings o el modelo BERT, tiene varias implicaciones en comparación con representaciones tradicionales como Bag-of-Words (BoW).  1. **Representación continua vs. discreta**: Los embeddings proporcionan representaciones densas y continuas de palabras en un espacio vectorial, mientras que BoW genera representaciones dispersas y discretas donde muchas componentes son cero (sparsity) (Página 228).  2. **Contexto y significado**: Los embeddings como los contextuales de BERT permiten capturar el significado de las palabras basándose en su contexto específico dentro de una oración. Esto es crucial para entender variaciones de significado en diferentes contextos, algo que las representaciones tradicionales como BoW no pueden hacer, ya que tratan a cada palabra de forma independiente y no consideran su contexto (Página 267).  3. **Relaciones entre palabras**: Con un modelo de word embeddings, es posible ver la similitud entre palabras e incluso realizar operaciones aritméticas con los vectores que recogen el significado. Esto contrasta con BoW, donde las relaciones entre palabras no se pueden observar (Página 231).  4. **Eficiencia computacional**: Debido a la alta cantidad de ceros en las representaciones dispersas de BoW, el procesamiento puede ser menos eficiente en comparación con los embeddings, que tienen dimensiones más manejables y más información compacta sobre las palabras.  En resumen, las técnicas de embeddings ofrecen una forma más rica y efectiva de representar el significado de las palabras y sus relaciones, aprovechando tanto el contexto como la continuidad en la representación, superando las limitaciones de las representaciones tradicionales como Bag-of-Words.",3410,349,3759
6.789000988006592,¿De qué manera el mecanismo de atención en modelos como Transformers ha revolucionado la traducción automática?,"El mecanismo de atención en modelos como Transformers ha revolucionado la traducción automática al permitir que el modelo evalúe diferentes partes de la secuencia de entrada de manera más eficiente y efectiva. En lugar de procesar la información de manera lineal como lo hacían los modelos anteriores, los Transformers utilizan un mecanismo de ""self-attention"" que considera simultáneamente todas las posiciones dentro de la secuencia. Esto les permite tener en cuenta el contexto de palabras en relación con otras palabras a lo largo de la oración, lo que mejora la calidad y la fluidez de las traducciones.  Este enfoque resulta especialmente útil en la traducción automática, ya que permite que el modelo maneje las complejidades del lenguaje de una manera más natural. Al integrar el ""self-attention"", la traducción no solo se basa en la secuencia de izquierda a derecha, sino que también incorpora una comprensión más rica del contexto completo. La arquitectura de Transformers, que incluye capas de atención cruzada y residual, facilita que el modelo decodificador utilice información del codificador de manera más efectiva, garantizando que la información del texto original se conserve y se traduzca adecuadamente.  Esto ha llevado a mejoras significativas en métricas de fidelidad y fluidez en comparación con modelos anteriores, estableciendo nuevos estándares en la traducción automática.  Cita: ""Modelo de transformers"", página 262; ""Transformers bidireccionales"", página 268; ""Evaluación de un modelo de MT"", página 292.",3533,304,3837
3.8545658588409424,¿Cómo se aborda el desafío de la ambigüedad semántica en el PLN mediante técnicas modernas?,"El desafío de la ambigüedad semántica en el procesamiento del lenguaje natural (PLN) se aborda mediante varias técnicas modernas, principalmente a través de algoritmos de desambiguación del sentido de las palabras. Estos algoritmos seleccionan el sentido correcto para una palabra de acuerdo a su contexto y a una lista de posibles significados. Existen diferentes enfoques para implementar estos algoritmos:  1. **Técnicas de aprendizaje automático supervisado**: Estos métodos requieren un corpus de palabras etiquetadas con sus significados correctos para poder entrenar un clasificador. Aunque proporcionan los mejores resultados, el acceso a estos datos etiquetados puede ser complejo y costoso.  2. **Entrenamiento indirecto utilizando diccionarios y bases de conocimiento**: Si no se dispone de un corpus etiquetado, se pueden utilizar diccionarios, tesauros y otras bases de conocimiento para realizar el entrenamiento de manera indirecta, aplicando algoritmos de aprendizaje supervisado débil.  Esto refleja que, aunque los enfoques supervisados son efectivos, la necesidad de datos etiquetados limita su uso, impulsando otras estrategias basadas en recursos lingüísticos existentes (NPL.pdf, ""Desambiguación del sentido de las palabras"", página 169).",3642,258,3900
3.7102572917938232,¿Qué ventajas ofrece el uso de modelos pre-entrenados en tareas específicas de PLN?,"Los modelos pre-entrenados ofrecen varias ventajas en tareas específicas de Procesamiento del Lenguaje Natural (PLN). En primer lugar, permiten aprovechar el conocimiento y las representaciones adquiridas durante su entrenamiento en grandes volúmenes de datos. Esto significa que pueden ser ajustados o ""fine-tuned"" para tareas específicas con una menor cantidad de datos de entrenamiento, lo que ahorra tiempo y recursos. Además, estos modelos tienen la capacidad de mejorar el rendimiento en diversas tareas contradictorias dentro del PLN, como el reconocimiento de entidades nombradas, análisis de sentimiento, y sistemas de traducción automática, entre otros, ya que proporcionan características generalizadas y robustas que pueden aplicarse a diferentes contextos.  Como se menciona en el documento, ""Incluye también modelos preentrenados como BERT, que se verán con más detalle en otros capítulos de la asignatura"" (Página 55). Esta capacidad de ser aplicados a múltiples tareas sin necesidad de un entrenamiento exhaustivo desde cero es uno de los aspectos más destacados de los modelos pre-entrenados en PLN.",3470,219,3689
6.409971237182617,¿Por qué es relevante la técnica de tokenización subword en el manejo de palabras desconocidas?,"La técnica de tokenización subword es relevante en el manejo de palabras desconocidas porque permite dividir palabras en subunidades más pequeñas o ""subpalabras"", lo que ayuda a modelar el significado de las palabras a partir de sus componentes. Esto es especialmente útil para manejar neologismos, errores tipográficos o palabras raras, ya que incluso si una palabra completa no está en el vocabulario del modelo, sus subcomponentes pueden estarlo. Así, el modelo puede tener una representación que facilite la comprensión del contexto y del significado, a pesar de la ausencia de la palabra completa.  Esta técnica mejora la capacidad del modelo para generalizar y trabajar con un vocabulario más diverso y poco conocido. Al permitir que el modelo forme representaciones significativas de palabras desconocidas a partir de sus partes, se optimiza el procesamiento del lenguaje natural (PLN) en tareas como la traducción automática y el análisis de sentimientos, entre otras.  Referencia: Procesamiento del Lenguaje Natural, Tema 8. Ideas clave, página 270.",3674,210,3884
4.8860626220703125,¿Cómo afecta el tamaño y diversidad de un corpus a la generalización de un modelo de PLN?,"El tamaño y la diversidad de un corpus son fundamentales para la generalización de un modelo de Procesamiento del Lenguaje Natural (PLN). Un corpus amplio y diverso permite al modelo aprender de una variedad de ejemplos, lo que mejora su capacidad para manejar diferentes situaciones, frases y construcciones lingüísticas. Si un modelo se entrena con un corpus limitado o poco diverso, es probable que no capture correctamente la riqueza del lenguaje, lo que puede llevar a un rendimiento deficiente en datos no vistos.  Por ejemplo, el coste y la dificultad de producir corpus anotados se convirtió en un factor limitante del uso de los enfoques supervisados para problemas del procesamiento del lenguaje, lo que llevó a una tendencia hacia el uso de técnicas de aprendizaje no supervisado en PLN (Archivo: NPL.pdf, Página 22). Esto implica que la variedad en los datos es crucial, ya que un corpus que cubra una amplia gama de contextos y estilos lingüísticos permitirá que el modelo sea más robusto y adaptable.  Además, la existencia de recursos anotados promovió la tendencia de atacar problemas complejos del procesamiento del lenguaje natural, lo que indica que un corpus diverso ayuda a entrenar modelos más sofisticados y precisos (Archivo: NPL.pdf, Página 20).",3715,255,3970
8.23102617263794,¿Qué rol desempeña el POS tagging en la mejora del análisis semántico de un texto?,"El etiquetado morfosintáctico (POS tagging) desempeña un rol crucial en la mejora del análisis semántico de un texto, ya que permite identificar las diferentes partes de la oración y asignar etiquetas a cada una de las palabras. Este proceso facilita la comprensión de la estructura y significado del texto.  En particular, el análisis semántico se basa en el principio de composición, donde el significado de una oración se construye a partir del significado de sus partes, lo que incluye tanto las palabras como su orden y agrupación. Al contar con el etiquetado morfosintáctico, que proporciona información sobre la categoría gramatical de cada palabra, se puede generar una representación más precisa del significado de la oración. La estructura sintáctica extraída del análisis morfosintáctico sirve como entrada para el análisis semántico, mejorando así la calidad de la representación semántica resultante (NPL.pdf, Página 136).  En resumen, el POS tagging no solo identifica las palabras y su función gramatical, sino que también establece una base para que el análisis semántico interprete correctamente el significado y las relaciones dentro de las oraciones.",2942,241,3183
4.665988206863403,¿Cómo se integran técnicas de machine learning supervisado en la clasificación de textos?,"Las técnicas de machine learning supervisado se integran en la clasificación de textos mediante el uso de un conjunto de instancias etiquetadas para entrenar un clasificador. Este clasificador, una vez entrenado, permite predecir el mejor sentido de las palabras ambiguas en el contexto de un texto. Para implementar estos algoritmos, se puede partir de un conjunto reducido de palabras ambiguas, seleccionando un número de instancias de su aparición en un corpus y etiquetándolas manualmente con el sentido correcto. Este proceso genera un modelo que puede desambiguar palabras o un texto entero, dependiendo de la cantidad de datos utilizados para el entrenamiento (Procesamiento del Lenguaje Natural, Página 171).   Además, es necesario contar con un corpus de textos etiquetados que incluya las categorías que se quieren predecir, como sentimientos, para que el modelo de aprendizaje automático pueda recibir y procesar la entrada de texto adecuadamente (Procesamiento del Lenguaje Natural, Página 298).",3829,203,4032
7.93415641784668,¿Qué desafíos presenta el manejo de lenguaje informal y cómo se pueden superar?,"El manejo de lenguaje informal presenta varios desafíos en el procesamiento del lenguaje natural. Uno de los principales retos es la variabilidad y la ambigüedad del lenguaje coloquial, donde las formas de expresión pueden ser muy diversas y dependen del contexto cultural y socioeconómico. Esto incluye el uso de jerga, modismos y abreviaturas, lo cual complica la comprensión y el análisis por parte de los algoritmos.  Además, el lenguaje informal a menudo carece de la estructura gramatical precisa que se encuentra en el lenguaje formal, lo que puede dificultar el etiquetado morfosintáctico y la interpretación semántica. Por ejemplo, los errores gramaticales y las construcciones no estándar son comunes en el lenguaje informal, lo que puede llevar a confusiones o malentendidos en la comunicación con los sistemas de procesamiento de lenguaje natural.  Para superar estos desafíos, se pueden implementar varias estrategias. Una opción es la formación de modelos específicos que se entrenen con grandes volúmenes de datos que incluyan lenguaje informal, lo que permitiría a los algoritmos aprender y adaptarse a las variaciones y peculiaridades del lenguaje coloquial. También se puede utilizar el análisis de contexto para interpretar mejor las expresiones en función de la connotación y el tono, lo que ayudaría a desambiguar significados.   Otra estrategia es la integración de recursos lingüísticos que incluyan ejemplos de lenguaje informal, como corpus de redes sociales o foros en línea, para enriquecer la base de conocimientos del sistema. Esto no solo mejoraría la capacidad de los modelos para manejar el lenguaje informal, sino que también facilitaría la conexión con las expresiones que los usuarios suelen emplear en su comunicación cotidiana.  Estas aproximaciones se alinean con las ideas presentadas en el documento sobre la necesidad de incorporar datos y evaluaciones basadas en el contexto del lenguaje y las especificidades del habla (Tema 2, Página 5).",1744,397,2141
3.365949869155884,¿Por qué es importante evaluar continuamente los modelos de PLN en entornos reales?,"Es importante evaluar continuamente los modelos de PLN en entornos reales porque permite comprobar la efectividad del modelo en aplicaciones prácticas y verificar si mejora el rendimiento en tareas específicas. Esta evaluación se puede realizar de dos maneras: extrínseca, que mide el rendimiento del modelo dentro de un sistema de PLN en funcionamiento, y aseguran que el modelo cumple con las expectativas y necesidades del usuario; e intrínseca, que utiliza un conjunto de datos de referencia para medir la precisión y la calidad del modelo en función de sus probabilidades asignadas a secuencias correctas.  Por lo tanto, la evaluación continua es esencial para ajustar y optimizar los modelos, garantizar su utilidad y llevar a cabo mejoras cuando sea necesario.  Referencias: - Evaluación de los modelos: perplejidad, Procesamiento del Lenguaje Natural, página 205.",3448,169,3617
3.820988893508911,¿Cómo se utiliza la desambiguación basada en contexto para mejorar la interpretación de palabras polisémicas?,"La desambiguación basada en contexto se utiliza para mejorar la interpretación de palabras polisémicas mediante la selección del sentido correcto de una palabra en función de su uso en un determinado contexto. Esta tarea se realiza a través de algoritmos de desambiguación que reciben una palabra con múltiples significados y analizan su contexto para determinar su interpretación adecuada.  Existen diferentes métodos para implementar esta desambiguación. Uno de los enfoques consiste en usar técnicas de aprendizaje automático supervisado que requieren un corpus de palabras etiquetadas con sus significados correctos para entrenar un clasificador. Aunque este enfoque suele proporcionar mejores resultados, la obtención de datos etiquetados puede ser compleja y costosa, lo que a veces limita su uso. Como alternativa, si no se dispone de un corpus etiquetado, se puede recurrir a diccionarios, tesauros u otras bases de conocimiento, aplicando así algoritmos de aprendizaje supervisado débil para realizar un entrenamiento indirecto (Información extraída de ""Procesamiento del Lenguaje Natural"", página 169).",2831,215,3046
4.903820514678955,¿Qué papel juegan las redes neuronales recurrentes (RNN) en la modelación de secuencias y cuáles son sus limitaciones?,"Las redes neuronales recurrentes (RNN) desempeñan un papel crucial en la modelación de secuencias, ya que utilizan no solo la información de entrada para calcular la salida, sino también la información de los estados previos. Esto les permite capturar la información secuencial, lo cual es especialmente útil para el procesamiento del lenguaje natural (PLN), donde las relaciones entre las palabras dependen de su contexto en la secuencia (NPL.pdf, Página 247).  Sin embargo, las RNN presentan limitaciones, como la dificultad para recordar información de estados anteriores que están lejanos en la secuencia. A pesar de que se han desarrollado variantes avanzadas como las LSTM para mitigar este problema, la pérdida de información puede seguir ocurriendo. Además, la estructura de las RNN dificulta la posibilidad de procesar la información en paralelo, lo que puede ser una desventaja en comparación con modelos más recientes, como los transformers (NPL.pdf, Página 256).",2907,205,3112
5.1509270668029785,¿Cómo se puede medir la eficacia de un modelo de PLN en tareas específicas?,"La eficacia de un modelo de procesamiento del lenguaje natural (PLN) en tareas específicas se puede medir a través de dos enfoques de evaluación: la evaluación extrínseca e intrínseca.   La evaluación extrínseca consiste en evaluar cómo funcionan los modelos a nivel de la aplicación de PLN para la que están siendo utilizados. Por ejemplo, en un sistema de reconocimiento de voz, se podría determinar si el rendimiento mejora al utilizar un modelo de lenguaje (LM) particular. Sin embargo, este tipo de evaluación puede ser costosa, ya que implica ejecutar todo un sistema de PLN.  Por otro lado, la evaluación intrínseca implica evaluar los resultados del modelo de lenguaje en relación a un conjunto de datos de referencia (test). Este conjunto se puede obtener separando directamente un corpus en datos de entrenamiento y test, similar a como se hace en el aprendizaje automático. En esta evaluación, se comparan modelos de lenguaje para determinar cuál ofrece una mayor probabilidad a las secuencias correctas. Además, el corpus original puede separarse en subconjuntos de entrenamiento, validación y test para realizar ajustes iniciales y decidir aspectos como el uso de bigramas o trigramas en la construcción del modelo de lenguaje (Evaluación de los modelos: perplejidad, página 205).  Esta forma de medir la eficacia permite una comprensión más clara de las capacidades del modelo en tareas específicas sin los costos asociados de la evaluación extrínseca.",3363,291,3654
6.239556312561035,¿Qué beneficios trae el uso del transfer learning en aplicaciones de PLN?,"El uso del transfer learning en aplicaciones de procesamiento de lenguaje natural (PLN) ofrece varios beneficios, principalmente relacionados con la eficacia y la eficiencia en el entrenamiento de modelos. Entre estos beneficios se encuentran:  1. **Reducción en los costos computacionales**: Entrenar un modelo desde cero, como BERT, es muy costoso computacionalmente ya que se utilizan grandes corpus de entrada. El transfer learning permite utilizar modelos preentrenados, lo que ahorra recursos significativos durante el proceso de entrenamiento.  2. **Transferencia de conocimiento**: El conocimiento que un modelo ha inferido durante su entrenamiento en una tarea específica se puede aplicar a otras tareas. Esto significa que se puede aprovechar el aprendizaje previo para mejorar el rendimiento en nuevas aplicaciones.  3. **Eficiencia en el tiempo de desarrollo**: Utilizar modelos preentrenados puede acelerar el tiempo necesario para desarrollar aplicaciones de PLN, ya que los modelos ya han adquirido un conocimiento robusto del lenguaje.  4. **Mejor rendimiento en tareas**: Al usar embeddings de un modelo preentrenado como entrada para otro proceso, se puede mejorar la calidad de las representaciones utilizadas para tareas específicas, lo que a su vez puede resultar en un mejor desempeño en las tareas de PLN.  Estos beneficios hacen del transfer learning una técnica muy valiosa en el ámbito del procesamiento de lenguaje natural (Transfer learning, Página 273).",3343,282,3625
4.102289199829102,¿Cómo se combinan técnicas de PLN y machine learning para detectar noticias falsas?,"Las técnicas de procesamiento del lenguaje natural (PLN) y el aprendizaje automático (machine learning) se combinan para detectar noticias falsas mediante la aplicación de algoritmos de aprendizaje supervisado y no supervisado. Esto implica el uso de grandes cantidades de datos textuales, que pueden incluir artículos de noticias y publicaciones en redes sociales, junto con técnicas de anotación para identificar características relevantes del texto, como la misión semántica y el contexto sintáctico.  Por ejemplo, se pueden aplicar máquinas de vectores de soporte (SVM), regresión logística multinomial y modelos bayesianos para clasificar textos en categorías de veracidad. Además, el aprendizaje no supervisado también puede ser útil, ya que permite agrupar textos sin la necesidad de anotaciones previas, lo cual ayuda en el etiquetado de noticias por similitudes de contenido y estilo.  Estas técnicas ayudan a modelar el comportamiento del lenguaje y a discriminar entre textos verídicos y falsos, a través del análisis de patrones y tendencias en el uso de ciertas palabras y estructuras lingüísticas. Esto fue mencionado en el contexto de cómo el avance del aprendizaje automático ha permitido abordar problemas complejos en el procesamiento del lenguaje natural, siendo clave en la clasificación de textos (NPL.pdf, Página 22).",801,257,1058
5.292140007019043,¿Qué importancia tiene la retroalimentación humana en la mejora de los modelos de PLN?,"La retroalimentación humana es crucial en la mejora de los modelos de Procesamiento del Lenguaje Natural (PLN) ya que permite ajustar y refinar estos modelos a partir de observaciones del rendimiento en tareas específicas. La evaluación extrínseca de los modelos de lenguaje (LM), que implica comprobar si el rendimiento mejora al usar un modelo determinado en una aplicación de PLN, es una forma en que la retroalimentación puede ser integrada. Este tipo de evaluación muestra cómo un modelo puede ser ajustado en función de su efectividad en aplicaciones prácticas, lo que es fundamental para el desarrollo continuo de estos sistemas. Sin embargo, es importante mencionar que la evaluación extrínseca puede resultar costosa, lo que a veces limita su aplicación (Archivo: NPL.pdf, Página 205).  La utilización de corpus anotados también desempeña un papel vital en la mejora de los modelos, ya que proporcionan ejemplos concretos que guían el aprendizaje automático supervisado. Sin estos recursos, el uso de enfoques supervisados para muchos problemas en PLN puede verse restringido, lo que llevó a un aumento en la tendencia hacia enfoques de aprendizaje no supervisado (Archivo: NPL.pdf, Página 22). Esto sugiere que la combinación de retroalimentación humana y la experiencia obtenida de datos anotados es esencial para el avance de la tecnología en este campo.",3277,275,3552
2.4335808753967285,¿Cómo se gestionan las palabras fuera de vocabulario (OOV) en modelos modernos de PLN?,"En modelos modernos de Procesamiento del Lenguaje Natural (PLN), se gestionan las palabras fuera de vocabulario (OOV) mediante técnicas de suavizado. Estas técnicas son fundamentales para evitar que se le asigne un valor de probabilidad de 0 a eventos no vistos. Por ejemplo, el suavizado de Laplace es una técnica sencilla que aumenta en 1 todas las ocurrencias de n-gramas en el conjunto de entrenamiento. Esto permite que las combinaciones no observadas, que normalmente tendrían una probabilidad de 0, obtengan un pequeño valor de probabilidad, garantizando así que se puedan generar dichas secuencias en el modelo. (Referencia: ""Técnicas de suavizado"", p. 211).",3007,152,3159
4.456140995025635,"¿De qué manera la integración de conocimiento externo (por ejemplo, knowledge graphs) puede enriquecer los modelos de PLN?","La integración de conocimiento externo, como los ""knowledge graphs"" (gráficos de conocimiento), puede enriquecer los modelos de procesamiento del lenguaje natural (PLN) al proporcionar contexto adicional y relaciones semánticas entre entidades. Esto permite que los modelos comprendan no solo las palabras y sus combinaciones, sino también la relevancia y el significado dentro de un contexto más amplio.   Por ejemplo, al utilizar un ""knowledge graph"", un modelo de PLN puede mejorar la precisión en tareas como la respuesta a preguntas o la generación de texto, al tener acceso a información estructurada sobre temas, relaciones entre distintos conceptos y entidades. Esto es especialmente útil en aplicaciones donde el conocimiento de fondo es crucial, como en sistemas de traducción automática o análisis de sentimientos.  Aunque el contexto proporcionado no aborda directamente el uso de ""knowledge graphs"", se menciona que la interacción de diferentes enfoques en PLN ha llevado a una comprensión más rica de los problemas complejos del lenguaje, sugiriendo que el conocimiento adicional puede proporcionar un soporte valioso en la resolución de estos problemas (Tema 1, Página 20).",3208,223,3431
4.324196100234985,¿Cómo contribuye la normalización de texto a la reducción de sesgos en los modelos de PLN?,"La normalización de texto contribuye a la reducción de sesgos en los modelos de Procesamiento del Lenguaje Natural (PLN) al permitir que los textos se transformen en variables de entrada que son más uniformes y menos propensas a reflejar prejuicios o desigualdades inherentes al lenguaje humano. Este proceso implica pasos como la tokenización, que descompone el texto en sus componentes, facilitando la extracción de características relevantes sin el ruido causado por variaciones no deseadas de formato o estilo (como se menciona en ""Técnicas de normalización de textos"", página 42).  Al estructurar el texto de manera que se eliminan o se minimizan elementos que podrían inducir a sesgos, los modelos pueden enfocarse en el contenido semántico más puro, lo que potencialmente resulta en decisiones y clasificaciones más justas y equilibradas. Así, la normalización actúa como un filtro que mejora la calidad de los datos de entrenamiento y, por ende, la capacidad del modelo para realizar inferencias más objetivas y precisas sobre el texto analizado.",3326,223,3549
3.8667495250701904,¿Qué papel tiene la evaluación automatizada en el ciclo de desarrollo de modelos de PLN?,"La evaluación automatizada desempeña un papel crucial en el ciclo de desarrollo de modelos de procesamiento del lenguaje natural (PLN). Se considera que existen dos tipos de evaluaciones: extrínsecas e intrínsecas. La evaluación extrínseca consiste en evaluar el funcionamiento del modelo en el contexto de la aplicación de PLN que lo utiliza, lo cual puede ser costoso debido a la necesidad de ejecutar todo el sistema. Por otro lado, la evaluación intrínseca se centra en los resultados del modelo de lenguaje en comparación con un conjunto de datos de referencia, que se elige del corpus utilizado para entrenar el modelo, separándolo en conjuntos de entrenamiento y prueba.  En un sentido más profundo, los modelos se pueden comparar en términos de la probabilidad que otorgan a las secuencias correctas. De este modo, la evaluación automatizada es fundamental para ajustar las probabilidades y optimizar el rendimiento del modelo a través de métricas cuantitativas, lo que garantiza que el modelo desarrollando cumpla con los estándares deseados en tareas específicas de PLN.  Referencias: - ""Evaluación de los modelos: perplejidad"", Página 205.",3225,236,3461
5.8672168254852295,¿Cómo influye el diseño del corpus en la detección y análisis de opiniones en redes sociales?,"El diseño del corpus influye en la detección y análisis de opiniones en redes sociales de manera significativa, ya que el corpus debe contener texto que represente adecuadamente la variedad de opiniones y sentimientos que los usuarios pueden expresar. Un corpus bien diseñado asegura que se capturen las nuances del lenguaje, incluyendo palabras y frases que pueden representar sentimientos positivos, negativos o neutros. Esto es esencial para que las técnicas de procesamiento del lenguaje natural (PLN) y los modelos de aprendizaje automático clasifiquen correctamente las opiniones de los usuarios.  Además, al realizar análisis automáticos sobre textos libres que provienen de encuestas o comentarios en redes sociales, es fundamental que el corpus incluya ejemplos relevantes y variados sobre los temas que se están evaluando. Esto permite que los algoritmos de aprendizaje puedan identificar patrones y realizar clasificaciones precisas sobre el sentimiento expresado. Sin un corpus bien diseñado, la capacidad de los modelos para realizar un análisis preciso se ve comprometida, lo que podría llevar a resultados inválidos o engañosos. Esto se destaca en el contexto donde se menciona que las técnicas de PLN se utilizan para extraer información relevante de los textos y clasificarla en categorías de sentimiento (Archivo: NPL.pdf, Página 10).",1080,250,1330
4.6671600341796875,¿Qué estrategias se pueden utilizar para mejorar la precisión en tareas de traducción automática?,"Para mejorar la precisión en tareas de traducción automática, se pueden utilizar las siguientes estrategias:  1. **Uso de modelos de redes neuronales**: Emplear arquitecturas más actuales basadas en redes neuronales para la traducción, que permiten capturar relaciones más complejas en los datos y mejorar la calidad de las traducciones.     2. **Evaluación de resultados**: Implementar métodos de evaluación que no se limiten a comparar traducciones a nivel de cadenas de caracteres, sino que utilicen medidas que evalúen embeddings. Esto proporciona mayor flexibilidad al comparar traducciones, permitiendo que sinónimos y diferencias en el orden de las palabras sean tratados adecuadamente (página 293).  3. **Consideración de sesgos**: Tener en cuenta los sesgos presentes en los datos de entrenamiento, que pueden influir en las traducciones producidas. Es fundamental abordar este aspecto ético para desarrollar modelos más justos y precisos (página 293).  4. **Manejo de divergencias lingüísticas**: Reconocer y adaptar el sistema a las diferencias entre lenguas, tanto en términos léxicos como estructurales. Una traducción efectiva no debe limitarse a traducir palabras individualmente, sino considerar el contexto y la estructura completa de la frase (página 283).  Estas estrategias, combinadas, pueden ayudar a obtener resultados más precisos y representativos en las tareas de traducción automática.",2591,294,2885
8.749797821044922,¿Cómo se relaciona la estructura gramatical con el éxito de un modelo de PLN?,"La estructura gramatical es fundamental para el éxito de un modelo de Procesamiento del Lenguaje Natural (PLN) porque se necesita una comprensión precisa de las relaciones estructurales entre las palabras para realizar un análisis sintáctico efectivo. Esta información se modela mediante gramáticas, como las gramáticas de estructura sintagmática y las gramáticas de dependencias, que facilitan el análisis de cómo los elementos léxicos se relacionan entre sí. La precisión en el análisis sintáctico es crucial, ya que una representación incorrecta podría generar interpretaciones semánticas erróneas, afectando así la calidad del modelo de PLN.  En el análisis sintáctico se considera la estructura de las frases y se busca resolver problemas como la ambigüedad estructural, que son comunes en el procesamiento del lenguaje. La capacidad de un modelo de lenguaje para entender y manejar estas sutilezas aumenta su efectividad en tareas como traducción automática, análisis de sentimientos y sistemas de preguntas y respuestas (Question Answering) (Tema 4. Ideas clave, p. 93; Tema 5. Ideas clave, p. 150).",3241,232,3473
5.817323446273804,¿Qué retos plantea la actualización constante de modelos de PLN en entornos de rápida evolución tecnológica?,"La actualización constante de modelos de PLN en entornos de rápida evolución tecnológica plantea varios retos, entre los cuales se destacan:  1. **Adaptación a Nuevos Datos**: Los modelos deben ser capaces de integrar y aprender de nuevos conjuntos de datos que pueden aparecer con frecuencia, lo que requiere un proceso continuo de entrenamiento y ajuste para mantener su rendimiento (NPL.pdf, Página 20).  2. **Recursos Limitados para Entrenamiento**: La dificultad de producir corpus anotados puede limitar el uso de enfoques supervisados, obligando a los investigadores a buscar alternativas como el aprendizaje no supervisado, lo cual puede no ser siempre efectivo (NPL.pdf, Página 22).  3. **Costos de Evaluación**: Realizar evaluaciones extrínsecas de modelos puede ser costoso y complicado, lo que lleva a buscar métricas intrínsecas que puedan no reflejar el rendimiento real en aplicaciones del mundo real (NPL.pdf, Página 205).  4. **Afrontar Problemas de Ambigüedad**: Dado que el lenguaje es inherentemente ambiguo, actualizar los modelos para manejar este tipo de incertidumbre estructural sigue siendo un desafío (NPL.pdf, Página 102).  5. **Incorporación de Nuevas Técnicas**: La rápida evolución de técnicas de modelado, como el uso de transformers, requiere una actualización continua de las arquitecturas de los modelos para aprovechar las mejoras en eficiencia y efectividad (NPL.pdf, Página 256).  Estos retos requieren un enfoque dinámico y flexible en el desarrollo y mantenimiento de modelos de PLN para asegurar su relevancia y eficacia en entornos cambiantes.",3228,339,3567
7.531706809997559,¿Cuáles son las limitaciones de los enfoques tradicionales en PLN y cómo las superan los métodos basados en deep learning?,"Los enfoques tradicionales en el procesamiento del lenguaje natural (PLN) presentan varias limitaciones, entre las que se destacan:  1. **Dependencia de características manuales**: Los métodos tradicionales a menudo dependen de la creación de características de alto nivel, lo cual puede ser laborioso y subjetivo. 2. **Modelos lineales**: Muchos de estos enfoques utilizan modelos lineales que pueden no capturar la complejidad de las relaciones no lineales en el lenguaje. 3. **Dificultades en la representación del contexto**: Los métodos clásicos, como los n-gramas, se enfrentan a desafíos para mantener el contexto a largo plazo en textos, ya que representan el lenguaje de manera secuencial y local.  Los métodos basados en deep learning, como las redes neuronales profundas y los transformers, superan estas limitaciones de varias maneras:  - **Extracción automática de características**: Los modelos de deep learning pueden aprender representaciones de características automáticamente a partir de grandes volúmenes de datos, eliminando la necesidad de ingeniería de características manual. - **Captura de relaciones complejas**: Las redes neuronales profundas pueden modelar relaciones no lineales y complejas en los datos, lo que les permite mejorar la comprensión semántica del lenguaje. - **Mantenimiento del contexto**: Las arquitecturas como los transformers utilizan mecanismos de atención (self-attention) que permiten a los modelos considerar la integralidad del contexto en el procesamiento de secuencias largas, gestionando mejor la información a través de diferentes partes del texto.  (Referencia: ""Transformers"", Página 256; ""Aplicaciones del PLN"", Página 281)",3329,340,3669
4.351901054382324,¿Cómo se puede evaluar la robustez de un modelo de PLN ante textos con lenguaje figurado o irónico?,"La robustez de un modelo de procesamiento de lenguaje natural (PLN) ante textos con lenguaje figurado o irónico puede evaluarse a través de la ejecución de pruebas específicas que se enfoquen en esos tipos de textos. Esto implica la creación o selección de un conjunto de datos de prueba que contenga ejemplos de lenguaje figurado, ironía y metáforas. A través de la evaluación intrínseca, se puede utilizar métricas como la perplejidad (perplexity, PP) para medir cuán bien el modelo logra predecir o generar texto en estos casos complejos.  Además, se pueden realizar evaluaciones extrínsecas, donde se analizan los resultados del modelo en aplicaciones específicas de PLN que se ocupan de identificar o responder a ironías y figuras literarias en los textos. Esto puede incluir la comparación de las respuestas generadas por el modelo ante consultas que contienen ironía con aquellas en un contexto literal.  La capacidad del modelo para mantener un rendimiento aceptable en estas circunstancias es un indicador clave de su robustez frente a desafíos lingüísticos más complejos.  Referencia: “Evaluación de los modelos: perplejidad,” Procesamiento del Lenguaje Natural, Página 205.",3208,247,3455
4.489217281341553,¿De qué manera la incorporación de knowledge graphs puede mejorar la capacidad inferencial de un modelo de PLN?,"La incorporación de knowledge graphs (gráficos de conocimiento) puede mejorar la capacidad inferencial de un modelo de procesamiento de lenguaje natural (PLN) al proporcionar una estructura semántica que facilita la comprensión de las relaciones entre entidades. Los knowledge graphs organizan información y conceptos en forma de nodos y aristas, permitiendo a los modelos inferir conexiones y relaciones que no están explícitamente mencionadas en el texto. Esto puede ser particularmente útil en tareas como el análisis de sentimientos o sistemas de respuesta a preguntas, donde comprender el contexto y las relaciones puede llevar a mejores interpretaciones y respuestas más precisas.  Por ejemplo, según el documento, ""los sistemas de Question Answering buscan responder a consultas de los usuarios en base a la información disponible en una colección de documentos"" (archivo: NPL.pdf, página 281). Al integrar un knowledge graph en estos sistemas, se facilita la recuperación de información relevante, ya que el modelo puede hacer inferencias sobre las relaciones entre diferentes entidades y conceptos, mejorando así la calidad de las respuestas proporcionadas.",3664,213,3877
3.0772640705108643,¿Qué desafíos éticos surgen al implementar sistemas de PLN en contextos sensibles y cómo se pueden mitigar?,"Los desafíos éticos que surgen al implementar sistemas de Procesamiento del Lenguaje Natural (PLN) en contextos sensibles incluyen el problema de los sesgos. Estos sesgos pueden manifestarse en la forma en que los modelos interpretan o generan contenido, lo que puede perpetuar estereotipos o discriminar a ciertos grupos.   Para mitigar estos problemas, es importante tener en cuenta aspectos éticos en el desarrollo del modelo, asegurándose de que el conjunto de datos utilizado para entrenar el modelo sea representativo y diverso, así como llevar a cabo evaluaciones rigurosas para identificar sesgos antes de su implementación.   Referencias: - “Introducción y objetivos”, Pág. 281.",1506,146,1652
4.950472116470337,¿Cómo influye la calidad del corpus en la capacidad de un modelo para generalizar a dominios específicos?,"La calidad del corpus es fundamental para la capacidad de un modelo de lenguaje para generalizar a dominios específicos. Un corpus bien anotado y representativo del dominio de aplicación permite que el modelo aprenda patrones y estructuras lingüísticas relevantes, lo que resulta en un mejor rendimiento en tareas específicas. Por el contrario, un corpus de baja calidad o que no es representativo del dominio puede conducir a un aprendizaje deficiente, donde el modelo no capta las particularidades del lenguaje utilizado en ese contexto, lo que afecta negativamente su capacidad de generalización.  Además, si el corpus contiene sesgos o errores, estos se pueden propagar al modelo, limitando su efectividad. Por lo tanto, un corpus de alta calidad que refleje con precisión el dominio específico es crucial para que el modelo pueda generalizar adecuadamente a nuevas situaciones.  Esta relación entre la calidad del corpus y la generalización del modelo se destaca en la evaluación de los modelos y las técnicas de aprendizaje supervisado, donde el conjunto de datos de referencia es esencial para ajustar y evaluar el rendimiento del modelo en contextos específicos (NPL.pdf, Página 205).",3845,227,4072
7.751553058624268,"¿Cuáles son las principales diferencias en la implementación de tokenización basada en palabras versus tokenización subword, y qué implicaciones tiene cada una?","La implementación de tokenización basada en palabras y tokenización subword presenta diferencias clave que tienen implicaciones significativas para el procesamiento del lenguaje natural (NLP).  1. **Tokenización basada en palabras**: Este enfoque separa el texto en palabras completas, a menudo utilizando espacios en blanco como delimitadores. Sin embargo, este método presenta desafíos, especialmente con nombres propios, contracciones y palabras compuestas, lo que puede llevar a la pérdida de información semántica. Por ejemplo, se mencionan casos como ""Nueva York"", donde separar en dos tokens no tiene sentido, y nombres que pueden contener signos de puntuación como ""Dr."" o ""o'clock"" que deben ser tratados con cuidado (Página 44, Procesamiento del Lenguaje Natural).  2. **Tokenización subword**: En contraste, la tokenización subword utiliza una técnica que descompone las palabras en subunidades o subpalabras. Este método, implementado en modelos como BERT, permite que palabras raras o desconocidas se representen mediante combinaciones de subpalabras conocidas. Por ejemplo, el algoritmo WordPiece se utiliza para dividir palabras en partes de estas en lugar de tratar palabras enteras, lo que ayuda a manejar vocabularios extensos y mejorar la comprensión del contexto (Página 270, Procesamiento del Lenguaje Natural).  **Implicaciones**: - La tokenización basada en palabras puede resultar en un vocabulario limitado y problemas con la representación de términos complejos o poco frecuentes. - La tokenización subword, al permitir la creación de tokens más flexibles, mejora la capacidad del modelo para generalizar a palabras diferentes o poco comunes, lo cual es crucial para tareas de aprendizaje automático que implican vocabularios cambiantes y escenarios dinámicos en NLP (Página 278, Procesamiento del Lenguaje Natural).  En resumen, la elección entre tokenización basada en palabras y subword influye directamente en la eficacia del análisis semántico y la capacidad de los modelos de NLP para manejar variaciones en el lenguaje.",3469,412,3881
15.400439739227295,¿Qué papel juega el mecanismo de atención en la mejora de la traducción automática y la generación de texto?,"El mecanismo de atención desempeña un papel crucial en la mejora de la traducción automática y la generación de texto al permitir que los modelos se concentren en partes específicas de la entrada de texto mientras producen la salida. Este mecanismo ayuda a mapear información relevante desde el texto original (entrada) a la salida (traducción o generación de texto) de manera más efectiva.  En particular, se destaca que ""la capa de cross attention permite que el modelo decoder reciba como información para la traducción la información asociada al modelo encoder sobre el texto original"" (NPL.pdf, Página 292). Esto implica que el modelo puede hacer referencia a las partes más relevantes del texto original durante el proceso de generación, mejorando así la precisión y fluidez de la salida generada.   Por lo tanto, el mecanismo de atención no solo optimiza la calidad de las traducciones automáticas al considerar el contexto y la estructura del texto, sino que también es fundamental para la generación coherente de texto en sistemas de procesamiento del lenguaje natural.",3909,209,4118
4.633781909942627,¿Cómo se pueden mitigar los errores de desambiguación semántica en modelos de PLN mediante el uso de contexto ampliado?,"Para mitigar los errores de desambiguación semántica en modelos de Procesamiento del Lenguaje Natural (PLN), se puede utilizar contexto ampliado, que permite a los algoritmos identificar el sentido correcto de las palabras en función de su uso en contextos más ricos. Este enfoque se basa en el reconocimiento de que una palabra puede tener múltiples significados y que el contexto en el que se encuentra puede ayudar a seleccionar el significado adecuado.  Uno de los métodos para lograr esto es a través de algoritmos de desambiguación del sentido de las palabras que toman en cuenta más información contextual en lugar de limitarse a un conjunto reducido de palabras cercanas. Por ejemplo, en lugar de solo considerar las palabras adyacentes, los modelos pueden analizar oraciones completas o incluso párrafos, mejorando así la precisión de la desambiguación.  Además, existen alternativas como el uso de diccionarios, tesauros y bases de conocimiento que permiten un entrenamiento más efectivo de los algoritmos mediante el análisis de términos en contextos más amplios, facilitando una desambiguación más precisa.  Este enfoque es vital porque, como se menciona, ""los métodos para el análisis semántico composicional que se han estudiado... no tienen en cuenta que una palabra puede tener más de un significado... el problema de la ambigüedad léxica... es una realidad existente y es un problema importante en el procesamiento del lenguaje natural."" (NPL.pdf, Página 169).",3684,299,3983
6.133451700210571,¿Qué estrategias se pueden implementar para mejorar la interpretabilidad de modelos complejos en PLN?,"Para mejorar la interpretabilidad de modelos complejos en el procesamiento del lenguaje natural (PLN), se pueden implementar diversas estrategias, tales como:  1. **Uso de técnicas de visualización**: La visualización de los resultados y de cómo los datos fluyen a través de un modelo puede ayudar a comprender mejor su funcionamiento. Esto puede incluir gráficos que muestren la importancia de distintas características o cómo se toman decisiones en el modelo.  2. **Explicaciones basadas en ejemplos**: Utilizar ejemplos concretos para ilustrar cómo un modelo realizó una clasificación o predicción puede hacer que los resultados sean más comprensibles para los usuarios.  3. **Interacción con el modelo**: Permitir a los usuarios interactuar con el modelo, probando diferentes entradas y observando cómo cambian los resultados, puede aumentar la comprensión de su comportamiento.  4. **Modelos más simples como referencia**: Comparar el modelo complejo con un modelo más simple que sea más interpretable (por ejemplo, una regresión lineal) puede ayudar a resaltar los puntos clave y las decisiones fundamentales del modelo más complejo.  5. **Metodologías de evaluación de modelos**: Implementar métricas cuantitativas que permitan evaluar la efectividad del modelo de manera clara y comprensible puede contribuir a su interpretación.  6. **Construcción de modelos con características interpretables**: Optar por modelos que son naturalmente más interpretables, como árboles de decisión, para ciertas tareas.  Estas estrategias no solo facilitan la comprensión de cómo funcionan los modelos, sino que también promueven la confianza del usuario en los resultados obtenidos del PLN.   Para información más detallada sobre evaluaciones de modelos y cómo mejorar su comprensión, puedes referirte a la sección sobre ""Evaluación de los modelos: perplejidad"" en el documento, específicamente en la página 205.",3527,377,3904
3.803632974624634,¿De qué forma el transfer learning ha modificado el panorama del desarrollo de modelos de PLN para tareas específicas?,"El transfer learning ha modificado el panorama del desarrollo de modelos de Procesamiento del Lenguaje Natural (PLN) al permitir que los modelos preentrenados, como BERT, se reutilicen para diversas tareas específicas sin necesidad de entrenarlos desde cero. Esto no solo reduce el coste computacional asociado con el entrenamiento de modelos grandes en corpus extensos, sino que también permite a los desarrolladores aplicar conocimientos previamente adquiridos en una tarea a otra, facilitando el acceso a tecnologías avanzadas en PLN.  Además, el uso del transfer learning permite que los modelos se ajusten más rápidamente a tareas concretas, ya que ya poseen un conocimiento general del lenguaje adquirido a partir de un corpus amplio. En resumen, el transfer learning hace que el desarrollo de modelos de PLN sea más eficiente y accesible, abriendo las puertas a aplicaciones más diversas y efectivas en este campo.   (Referencia: ""Transfer learning"", Página 273)",3445,189,3634
4.912653684616089,¿Cómo se puede medir la eficacia de un modelo de PLN en la detección de noticias falsas?,"La eficacia de un modelo de procesamiento del lenguaje natural (PLN) en la detección de noticias falsas no se discute explícitamente en el contexto proporcionado. Sin embargo, se pueden extrapolar algunos enfoques generales para evaluar modelos de PLN, que podrían aplicarse a la detección de noticias falsas.   Se presentan dos tipos de evaluaciones: extrínseca e intrínseca. La evaluación extrínseca implica evaluar cómo funciona el modelo dentro del contexto de una aplicación específica, como sería un sistema que identifica noticias falsas. Esto puede incluir métricas como la precisión, el recall y la F1-score, que permiten medir el rendimiento del modelo directamente en la tarea de detección de noticias falsas.   Por otro lado, la evaluación intrínseca se enfoca en evaluar los resultados del modelo respecto a un conjunto de datos de referencia. Esto podría significar usar un conjunto de datos que contenga ejemplos de noticias verdaderas y falsas para medir la capacidad del modelo para clasificar correctamente estas entradas.  En resumen, la eficacia de un modelo de PLN para detectar noticias falsas se podría medir mediante evaluaciones extrínsecas e intrínsecas, utilizando métricas específicas que consideren la precisión y la calidad de las detecciones.  Referencias: - ""Evaluación de los modelos: perplejidad"", Página 205. - ""Unión de las diferentes vertientes: 1994-1999"", Página 20.",1939,291,2230
7.695105791091919,"¿Qué implicaciones tiene la integración de datos multimodales (texto, imagen, audio) en los modelos de PLN?","El contexto proporcionado no aborda directamente la integración de datos multimodales en los modelos de PLN. Sin embargo, se pueden inferir algunas implicaciones a partir de los temas tratados.   La integración de datos multimodales, como texto, imagen y audio, en los modelos de PLN puede enriquecer la comprensión del lenguaje al proporcionar un contexto adicional para interpretar el contenido. Por ejemplo, en aplicaciones de PLN que requieren una comprensión más profunda, como la traducción automática o el análisis de sentimientos, la información visual o auditiva puede ofrecer pistas que mejoren la precisión de los modelos.  Además, los modelos de PLN que utilizan datos multimodales enfrentan nuevos desafíos en términos de diseño de arquitectura, procesamiento y evaluación. Pueden requerir técnicas avanzadas, como la que se aborda en relación con los transformers y la capa de self-attention, para manejar y fusionar efectivamente las diferentes modalidades de datos, asegurando que la información relevante de cada tipo de entrada se aproveche.  Para ilustrar, la utilización de técnicas de PLN en el análisis de historias clínicas en el ámbito médico ya sugiere la necesidad de combinar diferentes tipos de datos para obtener una imagen más completa del paciente (Página 11). Aunque el texto mencionado no aborda específicamente la combinación de imágenes o audio, la inferencia es clara: el uso de datos variados puede ser crucial para un análisis más robusto y completo en diversos contextos.  Por lo tanto, aunque el documento no proporciona una descripción específica de estos efectos, se puede concluir que la integración de datos multimodales puede ofrecer un valor añadido en la eficacia de los modelos de PLN, mientras que también introduce una complejidad adicional en su diseño y evaluación.",3342,343,3685
4.586135149002075,¿Cómo se puede abordar el problema de los sesgos en los modelos de PLN derivados de datos de entrenamiento poco representativos?,"Para abordar el problema de los sesgos en los modelos de Procesamiento del Lenguaje Natural (PLN) que surgen de datos de entrenamiento poco representativos, es importante considerar varios enfoques. Uno de los enfoques más destacados es realizar auditorías de sesgos en los datos de entrenamiento y en los resultados de los modelos. Esto incluye identificar y analizar las fuentes de sesgos que pueden existir en los datos y su influencia en el rendimiento del modelo.  Además, se pueden implementar técnicas de reducción de sesgos, como el ajuste de los datos para equilibrar las representaciones de diferentes grupos demográficos o la inclusión de datos sintéticos que reflejen una mayor diversidad. También es fundamental la participación de expertos en ética y diversidad durante el desarrollo del modelo, lo que puede ayudar a garantizar que las preocupaciones relativas al sesgo sean consideradas de manera integral.  Finalmente, una evaluación continua y el ajuste del modelo a lo largo de su vida útil son esenciales para mitigar la perpetuación de sesgos a medida que se expone a nuevos datos. Esto puede incluir métodos de aprendizaje continuo que adaptan el modelo con nuevos datos representativos y técnicas de monitoreo de rendimiento que buscan activamente detectar y corregir sesgos.  Estas estrategias son importantes para asegurar que los modelos de PLN sean justos y representativos, promoviendo así un mejor uso en aplicaciones reales.",3621,275,3896
4.543558359146118,¿Qué ventajas ofrece el uso de modelos basados en Transformers frente a las RNN tradicionales en el procesamiento de secuencias?,"Los modelos basados en Transformers ofrecen varias ventajas frente a las RNN tradicionales en el procesamiento de secuencias. En primer lugar, a diferencia de las RNN, que pueden enfrentar problemas como la pérdida de información desde etapas anteriores lejanas, los Transformers utilizan mecanismos de atención que permiten a la red considerar cualquier parte de la secuencia de entrada al generar una salida, lo que mejora la capacidad de capturar relaciones en secuencias largas.   Además, los Transformers facilitan el procesamiento paralelo de datos, a diferencia de las RNN, que procesan la información de manera secuencial. Esto significa que los Transformers pueden ser más eficientes en términos de tiempo de entrenamiento y en la ejecución de tareas, ya que no dependen de la información anterior de la misma manera que lo hacen las RNN.   Estas características hacen que los Transformers sean más adecuados para una variedad de tareas complejas en el procesamiento del lenguaje natural, como traducción automática y generación de texto, donde la comprensión y manejo del contexto es crucial.   Estas ventajas se describen en el contexto de ""Transformers"" y ""RNN apiladas"", en las páginas 256 y 251, respectivamente.",2855,239,3094
6.836476802825928,¿Cómo influye el preprocesamiento en la eliminación de ruido y en la mejora del rendimiento de un modelo de PLN?,"El preprocesamiento en el procesamiento de lenguaje natural (PLN) juega un papel esencial en la eliminación de ruido y en la mejora del rendimiento de los modelos. Este proceso implica la limpieza y transformación de los datos de texto brutos en un formato que sea más adecuado para el análisis. A través del preprocesamiento, se pueden filtrar palabras irrelevantes, corregir errores ortográficos y normalizar el texto, lo que disminuye la cantidad de ruido presente en los datos.   Al eliminar el ruido, se mejora la calidad de los datos que alimentan al modelo, lo que a su vez puede conducir a un mejor rendimiento en diversas tareas de PLN, como la clasificación de texto, la traducción automática, o el análisis de sentimientos. Así, un modelo entrenado con datos de mayor calidad tiende a tener un rendimiento más robusto y preciso.  Esto se relaciona también con el enfoque que se ha adoptado en la evaluación de modelos, donde se enfatiza la importancia de comparar el rendimiento de los modelos en función de la calidad de los datos utilizados para su entrenamiento (Archivo: NPL.pdf, Página 20). Además, factores como el canal de comunicación y el ruido del entorno pueden afectar la cercanía y calidad de la información procesada, lo que implica que el preprocesamiento se vuelve aún más crucial en entornos donde el ruido es un factor predominante (Archivo: NPL.pdf, Página 308).",3380,291,3671
5.761951446533203,¿Qué desafíos presenta la actualización en tiempo real de modelos de PLN en entornos dinámicos?,"El contexto proporcionado no menciona explícitamente los desafíos que enfrenta la actualización en tiempo real de modelos de procesamiento del lenguaje natural (PLN) en entornos dinámicos. Sin embargo, se puede inferir que algunos de los retos generales, vinculados a la adaptación de modelos en contextos de cambio rápido, incluyen:  1. **Costo y dificultad en la producción de corpus anotados**: La actualización constante de modelos de PLN puede depender de conjuntos de datos anotados, cuyo costo y dificultad para producir pueden representar un factor limitante. Esto es relevante porque la eficacia de los métodos supervisados y la capacitación de modelos actualizados requieren corpus que reflejen el lenguaje actual y los cambios contextuales (ver página 22).  2. **Adaptación a nuevas expresiones y jerga**: En entornos dinámicos, el lenguaje puede cambiar rápidamente, incorporando nuevas jerga, modismos o cambios en el uso del lenguaje. Los modelos deben ser actualizados con frecuencia para manejar estos cambios, lo que puede ser complicado.  3. **Evaluación y validación constante**: La necesidad de realizar evaluaciones frecuentes para asegurar que los modelos siguen siendo precisos y relevantes en sus predicciones es esencial. Esto puede implicar el uso de métodos de evaluación intrínseca y extrínseca, lo que añade un nivel de complejidad y recursos requeridos (ver página 205).  4. **Implementación y escalabilidad**: Actualizar modelos y mantener su eficacia en tiempo real implica desafíos técnicos en términos de infraestructura. La gestión de recursos computacionales y la capacidad de realizar actualizaciones sin interrumpir el servicio son aspectos críticos.  Aunque estos puntos no son específicamente sobre ""actualización en tiempo real"", son desafíos relacionados con la adaptación de los modelos de PLN a un entorno cambiante.",3528,363,3891
4.0751988887786865,¿Cómo se puede utilizar la retroalimentación de usuarios para ajustar y mejorar los modelos de PLN en aplicaciones prácticas?,"La retroalimentación de los usuarios puede ser fundamental para ajustar y mejorar los modelos de procesamiento del lenguaje natural (PLN) en aplicaciones prácticas. Una forma de hacerlo es a través de la evaluación extrínseca, donde se analiza el rendimiento del modelo en el contexto de la aplicación específica que lo utiliza. Esto implica evaluar cómo se comporta el modelo en tareas concretas, como el reconocimiento de voz o la clasificación de sentimientos, utilizando datos reales. El feedback directo de los usuarios sobre la precisión y relevancia de las respuestas generadas puede proporcionar información valiosa para hacer ajustes en el modelo.  Además, la retroalimentación puede ser utilizada para ajustar las probabilidades en los modelos de lenguaje y mejorar su desempeño general. Por ejemplo, al identificar secuencias que frecuentemente son clasificadas incorrectamente, se pueden ajustar las métricas del modelo para dar mayor peso a estas secuencias en el aprendizaje futuro.  Referencias: - ""Evaluación de los modelos: perplejidad"", página 205.",3532,204,3736
3.4191174507141113,¿Qué papel juegan las técnicas de data augmentation en el fortalecimiento de modelos de PLN?,"El contexto proporcionado no menciona explícitamente las técnicas de data augmentation ni su papel en el fortalecimiento de modelos de Procesamiento del Lenguaje Natural (PLN). Sin embargo, el data augmentation en general se utiliza para aumentar la cantidad de datos disponibles para entrenar modelos, lo que puede ayudar a mejorar su rendimiento al reducir el sobreajuste y proporcionar una mayor diversidad de ejemplos durante el entrenamiento.  Al aplicar técnicas de data augmentation, como la modificación de frases, la sustitución de sinónimos o la generación de texto artificial, se puede enriquecer el corpus de entrenamiento, similar a lo que se menciona en la tendencia hacia el uso de técnicas de aprendizaje no supervisado que aprovechan grandes cantidades de datos sin anotación alguna (NPL.pdf, página 22). Esto permite que los modelos de PLN sean más robustos y capaces de generalizar mejor en tareas específicas.  Para un entendimiento más profundo sobre las técnicas de data augmentation en PLN, sería recomendable consultar literatura específica sobre el tema, ya que el contenido proporcionado no detalla esta relación o su impacto de manera directa.",3471,222,3693
4.528618335723877,¿Cómo afecta la complejidad del lenguaje natural a la hora de diseñar modelos de PLN capaces de captar sutilezas semánticas?,"La complejidad del lenguaje natural presenta desafíos significativos al diseñar modelos de procesamiento de lenguaje natural (PLN) que puedan capturar sutilezas semánticas. Una de las dificultades radica en que el contexto y la ambigüedad inherentes en el lenguaje pueden dificultar la construcción de representaciones que sean precisas y relevantes. Por ejemplo, las arquitecturas más complejas, como las unidades LSTM (long short-term memory), se han propuesto para manejar problemas relacionados con la dinámica temporal y la relación a largo plazo en las secuencias de datos, lo que es crucial para el análisis semántico. Estas arquitecturas permiten a los modelos aprender dependencias a largo plazo, lo que es fundamental para comprender el contexto en el que se utilizan ciertas palabras u oraciones (Página 255).  Además, la integración del análisis semántico y el sintáctico es una estrategia que busca simplificar el proceso de análisis, al permitir la detección temprana de inconsistencias en la representación semántica. Sin embargo, esta integración también puede conllevar un costo en términos de procesamiento innecesario, si se dedican recursos a análisis semánticos que finalmente no contribuyen a construir una estructura sintáctica válida (Página 150). Esto resalta la necesidad de un balance entre la complejidad de los modelos y la efectividad en la captura de las sutilezas semánticas presentes en el lenguaje natural.",1864,295,2159
6.00290322303772,¿Por qué es crucial la evaluación continua de modelos en producción y cuáles son los métodos para llevarla a cabo?,"La evaluación continua de modelos en producción es crucial porque permite garantizar que el rendimiento del modelo se mantenga adecuado y se adapte a cambios en los datos o en las condiciones del entorno. A medida que un modelo es utilizado, puede enfrentarse a nuevos tipos de datos o situaciones que no estaban presentes durante su entrenamiento inicial, lo que puede hacer que su efectividad disminuya con el tiempo.  Para llevar a cabo esta evaluación, se pueden utilizar dos métodos principales:  1. **Evaluación extrínseca**: Se evalúa el modelo en función de su rendimiento dentro de una aplicación específica de procesamiento del lenguaje natural (PLN). Por ejemplo, se puede analizar si el rendimiento mejora al utilizar el modelo en un sistema de reconocimiento de voz.  2. **Evaluación intrínseca**: Se evalúan los resultados del modelo en relación con un conjunto de datos de referencia. Este conjunto de datos se puede obtener del corpus utilizado para entrenar el modelo, separándolo en datos de entrenamiento y de prueba. Comparando diferentes modelos de lenguaje, se considera que el que tiene mayores probabilidades para las secuencias correctas tendrá un mejor rendimiento (Referencia: ""Evaluación de los modelos: perplejidad"", página 205).",1610,247,1857
4.314688682556152,¿Qué estrategias se pueden aplicar para optimizar la eficiencia computacional sin sacrificar la precisión en modelos de PLN?,"Para optimizar la eficiencia computacional sin sacrificar la precisión en modelos de Procesamiento del Lenguaje Natural (PLN), se pueden aplicar las siguientes estrategias:  1. **Uso de arquitecturas de modelos avanzados como transformers**: Esta arquitectura soluciona problemas de pérdida de información en modelos de redes neuronales recurrentes (RNN) y permite el procesamiento en paralelo, lo cual es más eficiente. (Referencia: ""Transformers"", página 256).  2. **Evaluación intrínseca y extrínseca**: La evaluación intrínseca consiste en medir el rendimiento del modelo con un conjunto de datos de referencia, lo que permite realizar ajustes y validaciones sin necesidad de ejecutar todo un sistema de PLN, que podría ser costoso. (Referencia: ""Evaluación de los modelos: perplejidad"", página 205).  3. **Uso de técnicas de PLN para análisis automatizado**: Como en la cribado de currículos en Recursos Humanos, donde se pueden ordenar y procesar masivamente documentos, optimizando el tiempo y esfuerzo necesarios en tareas manuales. (Referencia: ""PLN para casos de uso concretos"", página 11).  Estas estrategias pueden contribuir a la eficiencia computacional en modelos de PLN manteniendo al mismo tiempo altos niveles de precisión.",1506,260,1766
6.205259561538696,¿Cómo se integran métodos de aprendizaje supervisado y no supervisado para enriquecer la comprensión del lenguaje en modelos híbridos?,"Los métodos de aprendizaje supervisado y no supervisado se integran en modelos híbridos para enriquecer la comprensión del lenguaje mediante la combinación de sus respectivas fortalezas. El aprendizaje supervisado se utiliza para tareas donde se dispone de un conjunto de datos anotados, lo que permite a los modelos aprender a partir de ejemplos específicos y etiquetados. Esto es especialmente útil en el análisis semántico y en problemas complejos, como el análisis sintáctico. Sin embargo, la producción de estos conjuntos de datos anotados puede ser costosa y limitar el uso de enfoques supervisados.  Por otro lado, el aprendizaje no supervisado ofrece una alternativa al permitir que los modelos aprendan sin la necesidad de datos etiquetados. Esto es especialmente valioso en contextos donde la anotación de corpus es difícil o impracticable. Los algoritmos de aprendizaje no supervisado pueden identificar patrones y relaciones inherentes en los datos, lo que lleva a un análisis morfosintáctico y semántico sin requerir anotaciones.  En este sentido, al combinar ambos enfoques, los modelos híbridos pueden beneficiarse de los datos anotados disponibles para tareas específicas mientras que, simultáneamente, aprovechan los vastos volúmenes de datos no anotados para aprender representaciones más generales y robustas del lenguaje. Este enfoque puede facilitar mejoras en tareas como la traducción automática, donde se requiere tanto la precisión de la traducción como la captación de las sutilezas del lenguaje natural.  Esto se menciona en el archivo: ""NPL.pdf (Página 22)"", que aborda cómo el costo y la dificultad de producir corpus anotados desempeñaron un papel importante en la tendencia hacia el uso de técnicas de aprendizaje no supervisado en el procesamiento del lenguaje natural.",3854,359,4213
3.5206668376922607,¿Qué desafíos presentan los idiomas con pocos recursos y cómo se pueden superar en el desarrollo de modelos de PLN?,"Los idiomas con pocos recursos presentan varios desafíos en el desarrollo de modelos de Procesamiento del Lenguaje Natural (PLN). Uno de los principales obstáculos es el coste y la dificultad de producir corpus anotados, lo que limita el uso de enfoques supervisados para muchos problemas del procesamiento del lenguaje. Como resultado, a partir de 2005 se observa una tendencia hacia el uso de técnicas de aprendizaje no supervisado en el PLN, permitiendo construir aplicaciones lingüísticas sin la necesidad de datos anotados. Esto incluye áreas como la traducción automática y el modelado de temas, donde los algoritmos de aprendizaje no supervisado han demostrado ser útiles (Archivo: NPL.pdf, Página 22).  Para superar estos desafíos, se pueden explorar métodos que requieran menos datos anotados, como el uso de transferencias de aprendizaje de idiomas que tienen más recursos a aquellos con menos. Esto permite que los modelos aprendan patrones generales que pueden ser adaptados a sistemas que operan en idiomas menos documentados. También se pueden considerar técnicas como el etiquetado semántico basado en características sintácticas, que no dependen en gran medida de grandes volúmenes de datos específicos (Archivo: NPL.pdf, Página 22). ",2992,248,3240
5.5924811363220215,¿Cómo influye la estructura gramatical del idioma en la elección de técnicas y algoritmos para el procesamiento del lenguaje?,"La estructura gramatical del idioma influye significativamente en la elección de técnicas y algoritmos para el procesamiento del lenguaje natural (PLN). Las gramáticas de estructura sintagmática modelan la información sintáctica y recogen las relaciones estructurales de una lengua, lo cual es esencial para realizar correctamente el análisis sintáctico. Es importante contar con una definición formal de la estructura sintáctica de una lengua para este propósito, ya que permite la elección del mejor resultado de análisis entre múltiples posibilidades, especialmente en situaciones de ambigüedad, que son comunes en el PLN.  La ambigüedad en la estructura de las frases afecta el funcionamiento de los analizadores sintácticos que utilizan gramáticas libres de contexto, y es fundamental que estos analizadores sean capaces de seleccionar un único resultado correcto. Para lograrlo, se emplean métodos como la desambiguación sintáctica, que requieren fuentes de conocimiento estadístico, semántico y contextual. Además, algunos métodos más avanzados integran la desambiguación directamente en el análisis sintáctico, lo que puede involucrar técnicas de programación dinámica y probabilísticas.  En resumen, la estructura gramatical condiciona no solo la representación de la información sintáctica, sino también la estrategia de desambiguación y los algoritmos utilizados para llevar a cabo el procesamiento del lenguaje natural.   (Título: ""Análisis sintáctico"", Página 93 y 97)",2274,291,2565
5.794879913330078,¿Qué papel juega la experimentación controlada en el ajuste fino de modelos de PLN y cómo se lleva a cabo?,"La experimentación controlada juega un papel crucial en el ajuste fino de modelos de Procesamiento del Lenguaje Natural (PLN), ya que permite evaluar y optimizar el rendimiento de estos modelos basándose en resultados cuantificables. Este proceso implica el uso de un conjunto de datos de referencia que se divide en datos de entrenamiento y test. Los datos de entrenamiento se utilizan para ajustar las probabilidades de las secuencias en el modelo de lenguaje, mientras que el conjunto de test se utiliza para su evaluación.  Al comparar dos modelos de lenguaje, el que asigne una mayor probabilidad a las secuencias correctas se considerará el mejor. Para obtener un rendimiento más refinado, el conjunto de datos original también puede separarse en subconjuntos de entrenamiento, validación y test, lo que permite hacer validaciones iniciales y ajustar parámetros, como decidir si utilizar bigramas o trigramas para la construcción del modelo de lenguaje.  Esto se menciona en el contexto de la evaluación de los modelos, donde se discuten tanto las evaluaciones extrínsecas (evaluar el modelo a nivel de la aplicación de PLN para la que se utiliza) como las intrínsecas (evaluar con respecto a un conjunto de datos de referencia, por ejemplo, haciendo una separación en datos de entrenamiento/test) (Archivo: NPL.pdf, Página 205).",3276,277,3553
10.598703145980835,¿Cómo diseñarías un protocolo experimental para evaluar la capacidad de un modelo de PLN en la detección de ambigüedades en textos complejos?,"Para diseñar un protocolo experimental que evalúe la capacidad de un modelo de Procesamiento del Lenguaje Natural (PLN) en la detección de ambigüedades en textos complejos, podríamos seguir los siguientes pasos:  1. **Definición de Ambigüedades**: Establecer un marco claro sobre qué se entiende por ambigüedad estructural en el contexto de PLN. La ambigüedad puede ser léxica, sintáctica o semántica.  2. **Selección de Textos**: Recopilar un corpus de textos complejos que contenga ejemplos de ambigüedades. Estos textos deben estar anotados previamente con las ambigüedades identificadas para efectos de validación.  3. **Modelo a Evaluar**: Seleccionar el modelo de PLN que se va a evaluar, justificando su elección con base en su arquitectura y su capacidad probada en tareas similares.  4. **Definición de Tareas**: Diseñar tareas específicas que el modelo debe realizar, como:    - Identificar y clasificar las ambigüedades en los textos.    - Proporcionar interpretaciones alternativas para las partes ambiguas del texto.  5. **Evaluaciones Extrínsecas e Intrínsecas**:    - **Evaluación Intrínseca**: Comparar las salidas del modelo con las anotaciones del corpus. Utilizar métricas como precisión, recall y F1-score para medir la eficacia del modelo en la detección de ambigüedades.    - **Evaluación Extrínseca**: Implementar el modelo en una aplicación específica, por ejemplo, en un sistema de análisis sintáctico o de traducción automática, y evaluar su rendimiento general en esta aplicación. Esto podría incluir cambios en la tasa de error de interpretación en contextos donde prevalezcan ambigüedades.  6. **Comparación con Baselines**: Comparar el desempeño del modelo con otros enfoques existentes o con modelos de referencia (baselines) que no aborden explícitamente la ambigüedad.  7. **Análisis de Resultados**: Realizar un análisis estadístico de los resultados obtenidos, identificando las categorías de ambigüedad que el modelo maneja mejor y aquellas que presenta más dificultades.  8. **Iteración y Mejora**: Basado en los resultados, iterar sobre el modelo y el protocolo, ajustando las tareas, el corpus o el modelo para mejorar la detección de ambigüedades.  Este protocolo experimental permite una evaluación sistemática de cómo un modelo de PLN maneja las ambigüedades, lo que es fundamental para tareas de análisis sintáctico y semántico complejas, donde la ambigüedad puede ser un desafío recurrente (ver ""Métodos probabilistas en el análisis sintáctico"", Página 115).",3332,593,3925
7.626447677612305,"¿Qué estrategias implementarías para mitigar sesgos en modelos de PLN, considerando la diversidad cultural y lingüística?","Para mitigar sesgos en modelos de procesamiento de lenguaje natural (PLN), es fundamental implementar varias estrategias que consideren la diversidad cultural y lingüística. Aquí hay algunas sugerencias:  1. **Diversidad en el conjunto de datos**: Asegurarse de que el conjunto de datos utilizado para entrenar los modelos sea diverso y representativo de diferentes culturas y lenguas. Esto incluye la recopilación de textos de diversas fuentes y géneros, así como la inclusión de dialectos y variantes lingüísticas.  2. **Análisis de sesgos**: Realizar un análisis exhaustivo de los datos y de los resultados del modelo para identificar posibles sesgos. Utilizar métricas cuantitativas para evaluar cómo los modelos pueden favorecer ciertos grupos sobre otros.  3. **Involucrar a comunidades diversas**: Colaborar con expertos y miembros de diferentes comunidades culturales para entender sus perspectivas y preocupaciones. Esto puede ayudar a diseñar modelos más inclusivos y a seleccionar adecuadamente los términos y las categorías.  4. **Técnicas de debiasing**: Implementar técnicas específicas de des-biasing en los modelos, que ayuden a corregir las decisiones sesgadas que puedan surgir a partir de datos históricos que reflejan desigualdades.  5. **Evaluación continua**: Realizar evaluaciones continuas del rendimiento del modelo en diferentes subgrupos para asegurarse de que siga siendo equitativo a lo largo del tiempo y ajustarlo según sea necesario.  6. **Educación y sensibilización**: Promover la conciencia sobre sesgos en la comunidad que trabaja con PLN. Capacitar a los desarrolladores y a los investigadores sobre la importancia de abordar este problema.  Al considerar estos enfoques, se contribuiría a crear modelos de PLN más justos y representativos, que puedan funcionar bien en contextos culturales y lingüísticos variados.   Para obtener información adicional sobre la interacción del PLN con diferentes problemáticas y enfoques, se puede consultar: ""Aplicaciones del PLN"" (página 7) y ""Aplicaciones industriales más habituales basadas en PLN"" (página 281).",2139,430,2569
8.306743860244751,¿Cómo abordarías el desafío de la interpretación de sarcasmo e ironía en sistemas de PLN?,"Abordar el desafío de la interpretación de sarcasmo e ironía en sistemas de Procesamiento de Lenguaje Natural (PLN) es complejo, ya que estas formas de comunicación dependen no solo del significado literal de las palabras, sino también de contextos culturales, emociones y entonación. Aquí algunas estrategias que se podrían considerar:  1. **Análisis de Sentimiento Profundo**: Incorporar modelos de análisis de sentimiento que vayan más allá de la simple detección de palabras positivas o negativas. Esto implica entender el contexto en el que se utilizan las palabras, ya que el sarcasmo a menudo se presenta en situaciones donde el significado es opuesto al expresado.  2. **Contextualización**: Utilizar técnicas de PLN que permitan analizar el contexto más amplio de una conversación o un texto. Esto podría incluir el uso de redes neuronales que toman en cuenta no solo las palabras en sí, sino también su relación entre sí y el contexto en el que aparecieron.  3. **Recopilación de Datos Etiquetados**: Crear un corpus específico donde se identifiquen ejemplos de sarcasmo e ironía, junto con su interpretación. Esto puede ayudar a entrenar modelos de aprendizaje automático para reconocer patrones asociados con dichos estilos de comunicación.  4. **Enriquecimiento del Lexicón**: Desarrollar un léxico que no solo incluya palabras con sentimientos negativos o positivos, sino también expresiones sarcásticas o irónicas que puedan influir en el sentimiento general del texto. Esto se puede usar como rasgos adicionales en modelos de aprendizaje supervisado (como se mencionó respecto al uso de palabras de sentimiento en el contexto de un lexicón) (NPL.pdf, pág. 299).  5. **Integración de la Prosodia**: Si se trabaja con datos de audio, la prosodia puede ser un indicador clave de sarcasmo e ironía. Analizar la entonación y el ritmo podría proporcionar pistas sobre la intención detrás de las palabras.  6. **Feedback Humano**: Implementar un sistema que permita a los humanos corregir o ajustar las interpretaciones del sistema, mejorando así el modelo a través del aprendizaje continuo.  Las estrategias mencionadas son solo el inicio para enfrentar el desafío de comprender el sarcasmo y la ironía en PLN; la investigación y los avances tecnológicos continúan evolucionando en esta área.",701,483,1184
6.282843351364136,"¿De qué manera integrarías conocimientos externos, como ontologías o knowledge graphs, en un modelo de PLN para mejorar su capacidad inferencial?","Para integrar conocimientos externos, como ontologías o knowledge graphs, en un modelo de PLN y mejorar su capacidad inferencial, se pueden seguir varios enfoques:  1. **Enriquecimiento de datos**: Utilizar ontologías para enriquecer los datos de entrada al modelo. Al incorporar información semántica, se puede mejorar la comprensión del contexto y las relaciones entre los conceptos. Esto permite que el modelo haga inferencias más precisas y relevantes.  2. **Representación de conocimiento**: Implementar representaciones vectoriales de las entidades y relaciones encontradas en knowledge graphs. Al transformar esta información en embeddings, se pueden combinar con embeddings de palabras para una representación más rica y contextualizada.  3. **Incorporación en procesos de entrenamiento**: Durante el entrenamiento del modelo, se puede integrar información de ontologías y knowledge graphs de manera que sirva como un recurso adicional para el aprendizaje. Esto ayuda a establecer relaciones entre términos que de otro modo podrían no ser evidentes.  4. **Uso de mecanismos de atención**: Incorporar capas de atención que puedan hacer referencia a entidades en una ontología o a nodos específicos en un knowledge graph. Esto permite que el modelo se enfoque en relaciones específicas que son relevantes para el contexto dado.  5. **Mejoramiento en tareas específicas**: Aplicar estos conocimientos en tareas específicas de PLN, como la desambiguación de palabras o el análisis de sentimientos, donde la relación entre los términos puede influir en la interpretación correcta del significado.  Estos enfoques permiten que el modelo de PLN no solo trabaje con el conocimiento explícito presente en los datos de entrenamiento, sino que también aproveche el conocimiento estructurado disponible en ontologías y knowledge graphs, aumentando así su capacidad inferencial.  Referencia: - ""Transformers"", Página 256.",3538,363,3901
9.88810133934021,¿Qué criterios utilizarías para determinar la calidad de un corpus destinado al entrenamiento de modelos de PLN en dominios especializados?,"Para determinar la calidad de un corpus destinado al entrenamiento de modelos de PLN en dominios especializados, se pueden utilizar los siguientes criterios:  1. **Representatividad**: El corpus debe reflejar con precisión el lenguaje y la terminología utilizados en el dominio especializado. Esto implica que debe incluir ejemplos diversos y representativos del tipo de textos que se encontraran en el dominio específico.  2. **Tamaño y cobertura**: Un buen corpus debe ser suficientemente grande para incluir suficientes ejemplos que permitan a los modelos generalizar. Además, debe cubrir aspectos variados del lenguaje, incluyendo jergas, modismos y variantes dialectales relevantes al dominio.  3. **Anotaciones**: La calidad y tipo de anotaciones (como etiquetas de partes del discurso, entidades nombradas, y relaciones semánticas) también son cruciales, ya que facilitan el aprendizaje y permiten evaluar el desempeño del modelo.  4. **Balacé**: La cantidad de ejemplos en diferentes categorías o clases también es importante. Un corpus bien balanceado asegura que el modelo no esté sesgado hacia un tipo de entrada.  5. **Actualización y temporalidad**: Dado que el lenguaje evoluciona, el corpus debe ser actualizado regularmente para incluir nuevos términos y usos que aparezcan en el campo.  6. **Calidad del texto**: La gramática, la ortografía y la claridad del lenguaje en el corpus también deben ser óptimas, ya que cualquier ruido en los datos puede afectar negativamente el rendimiento del modelo.  Estos criterios son fundamentales para garantizar que el corpus sea una base efectiva y robusta para el entrenamiento de modelos de PLN en contextos específicos.   Referencias: - ""Recursos lingüísticos necesarios para implementar tareas de procesamiento del lenguaje natural"" (p. 20) - ""El coste y la dificultad de producir corpus anotados"" (p. 22)",3574,377,3951
7.956427097320557,¿Cómo justificarías la elección de una arquitectura Transformer frente a otras alternativas en un proyecto de PLN avanzado?,"La elección de una arquitectura Transformer en un proyecto de Procesamiento de Lenguaje Natural (PLN) avanzado se puede justificar por varias razones clave:  1. **Manejo de dependencias a largo plazo**: A diferencia de las redes neuronales recurrentes (RNN), que pueden experimentar dificultades para manejar la información de etapas anteriores lejanas, los transformers utilizan un mecanismo de atención (self-attention) que les permite considerar simultáneamente todas las posiciones de la secuencia de entrada. Esto significa que pueden integrar información de manera más efectiva, lo que es crucial en tareas lingüísticas complejas donde el contexto importa (Página 256).  2. **Paralelización en el procesamiento**: Los transformers permiten el procesamiento de datos en paralelo, lo que mejora significativamente la eficiencia en comparación con las RNN, que procesan los datos secuencialmente. Esta característica es especialmente valiosa para manejar grandes volúmenes de datos en PLN, reduciendo el tiempo de entrenamiento y ejecución (Página 256).  3. **Embeddings contextuales mejorados**: Los transformers generan embeddings contextuales que consideran el contexto global y local de las palabras en una frase. Esta capacidad es fundamental para tareas que requieren entender el significado de las palabras en su contexto, como el análisis de sentimientos y la traducción automática (Página 277).  4. **Flexibilidad en la arquitectura**: La arquitectura de transformers puede adaptarse a diversas tareas de PLN, como la generación de texto, clasificación de sentimientos y sistemas de Question Answering, a través de un simple ajuste en la configuración de los bloques, sin necesidad de modificar drásticamente la estructura subyacente (Página 281).  5. **Uso de modelos preentrenados**: Los transformers, como BERT, utilizan una metodología de preentrenamiento que les permite capturar mejor las características del lenguaje antes de ser ajustados para tareas específicas. Esto puede aportar mejoras en el rendimiento al requerir menos datos etiquetados para la formación en tareas específicas (Página 268).  En conjunto, estas razones resaltan las ventajas de los transformers en comparación con otras arquitecturas, lo que los convierte en una opción preferida en proyectos de PLN avanzado.",2856,443,3299
9.272988319396973,¿Qué medidas tomarías para asegurar la escalabilidad y sostenibilidad en el entrenamiento de modelos de PLN a gran escala?,"Para asegurar la escalabilidad y sostenibilidad en el entrenamiento de modelos de PLN a gran escala, se pueden considerar las siguientes medidas:  1. **Uso de técnicas de aprendizaje no supervisado**: Esto permite construir aplicaciones lingüísticas a partir de datos sin anotación, lo que reduce los costos y la dificultad de producir corpus anotados. La necesidad de recursos anotados es un factor limitante en el uso de enfoques supervisados (NPL.pdf, Página 22).  2. **Implementación de modelos de representación vectorial**: Representar textos como vectores dentro de un espacio vectorial permite trabajar con ellos a nivel computacional, facilitando tareas como la recuperación de información. Esta representación es útil para garantizar que documentos similares tengan representaciones vectoriales semejantes, lo que puede ayudar en la eficiencia del entrenamiento (NPL.pdf, Página 216).  3. **Optimización del procesamiento**: Utilizar arquitecturas de red como transformadores, que permiten el procesamiento paralelo y minimizan la pérdida de información en etapas anteriores. Esto es fundamental para modelar secuencias de manera efectiva (NPL.pdf, Página 256).  4. **Uso de evaluaciones intrínsecas y extrínsecas**: Realizar evaluaciones tanto a nivel de aplicación (extrínsecas) como comparando resultados con conjuntos de referencia (intrínsecas) para optimizar el rendimiento de los modelos de lenguaje. Esto ayuda a ajustar modelos y decidir sobre configuraciones para mejorar la eficiencia y efectividad (NPL.pdf, Página 205).  5. **Consideración de la infraestructura**: Asegurar que la infraestructura de computación sea adecuada, con suficiente potencia de procesamiento y almacenamiento, para manejar la carga de entrenamiento de modelos a gran escala.  6. **Integración de técnicas éticas y conscientes de los sesgos**: Al desarrollar modelos, considerar los sesgos en los datos y aplicar técnicas que minimicen su impacto es crucial para asegurar la sostenibilidad y equidad de los modelos (NPL.pdf, Página 288).  Estas estrategias no solo optimizan el entrenamiento de los modelos, sino que también promueven su uso en aplicaciones industriales de manera responsable y sostenible.",3432,443,3875
5.3372156620025635,"¿Cómo evaluarías la capacidad de un modelo de PLN para adaptarse a cambios rápidos en el uso del lenguaje, como la aparición de nuevos modismos?","Para evaluar la capacidad de un modelo de procesamiento del lenguaje natural (PLN) para adaptarse a cambios rápidos en el uso del lenguaje, como la aparición de nuevos modismos, se podrían considerar varios enfoques:  1. **Evaluación Continua con Datos Actualizados**: Es esencial que el modelo sea evaluado de manera continua con datos recientes que incluyan los nuevos modismos. Esto permite identificar si el modelo puede reconocer y comprender estos términos en contexto.  2. **Transferencia de Aprendizaje**: Utilizar técnicas de transferencia de aprendizaje que permitan al modelo ajustar sus parámetros con nuevos datos sin necesidad de ser reentrenado completamente. Esto podría facilitar la incorporación de cambios lingüísticos sin perder eficacia en tareas previamente aprendidas.  3. **Análisis de Perplejidad**: Utilizar métricas de evaluación como la perplejidad para entender cómo se desempeña el modelo ante textos que contienen nuevos modismos. La perplejidad mide la incertidumbre del modelo sobre la próxima palabra en una secuencia y puede ayudar a evaluar su adaptabilidad.  4. **Estudio de Caso y Comparaciones**: Comparar el rendimiento del modelo en tareas específicas antes y después de la introducción de los nuevos modismos, para determinar si se mantienen o mejoran sus capacidades.  La capacidad de un modelo de PLN para reconocer y adaptarse a estos cambios es crucial para su efectividad en aplicaciones prácticas, especialmente en contextos donde el lenguaje evoluciona rápidamente.",3397,299,3696
6.8462815284729,¿Qué metodología propondrías para combinar modelos generativos y discriminativos en una arquitectura híbrida de PLN?,"Para combinar modelos generativos y discriminativos en una arquitectura híbrida de Procesamiento del Lenguaje Natural (PLN), se podría considerar la siguiente metodología:  1. **Uso de un modelo generativo para la representación del lenguaje**: Inicialmente, se podría utilizar un modelo generativo, como un modelo de lenguaje (LM) basado en RNN o transformers, para capturar la estructura básica del lenguaje y generar representaciones contextuales de las palabras o frases. Este enfoque permite explorar la riqueza del contexto y las relaciones semánticas entre palabras.  2. **Integración de un modelo discriminativo para la tarea específica**: Posteriormente, se podría implementar un modelo discriminativo, como una red neuronal alimentada hacia adelante o un modelo de clasificación, que tome las representaciones generadas por el modelo generativo como su entrada. Este modelo discriminativo se encargaría de realizar tareas específicas, como clasificación de sentimientos o etiquetado morfosintáctico.  3. **Entrenamiento conjunto**: Se podría optar por un entrenamiento conjunto, donde los parámetros del modelo generativo y del modelo discriminativo se optimicen simultáneamente para mejorar la coherencia entre ambas etapas. Esto permitiría que el modelo generativo se adapte mejor a las necesidades del modelo discriminativo, y viceversa.  4. **Evaluación y ajuste**: Finalmente, se realizaría una evaluación del rendimiento del sistema híbrido en tareas específicas, empleando métricas tanto intrínsecas como extrínsecas (página 205). A partir de los resultados obtenidos, se ajustarían los hiperparámetros y se podrían implementar técnicas de suavizado en el modelo generativo para mejorar la precisión en las salidas (página 198).  Esta metodología promueve la sinergia entre las fortalezas de los modelos generativos y discriminativos, maximizando el rendimiento en diversas aplicaciones de PLN.",3214,383,3597
9.114043235778809,¿Cómo analizarías críticamente la eficacia de las métricas tradicionales en la evaluación de la generación automática de lenguaje?,"Para analizar críticamente la eficacia de las métricas tradicionales en la evaluación de la generación automática de lenguaje, es esencial considerar varios factores.   En primer lugar, las métricas tradicionales a menudo se basan en comparaciones a nivel de cadenas de caracteres, lo que puede ser limitante. Por ejemplo, estas métricas no siempre reconocen la validez de una traducción o generación de texto que no siga exactamente el orden de palabras de la referencia original o que incluya sinónimos, lo que puede llevar a una subestimación de la calidad del texto generado (NPL.pdf, Página 293).  Además, la evaluación intrínseca usando métricas como la perplejidad (perplexity) se centra únicamente en la probabilidad de la secuencia de palabras, normalizada en función del número de palabras. Un resultado favorable en términos de perplejidad no siempre se traduce en un texto que sea coherente o significativo desde un punto de vista humano (NPL.pdf, Página 206). Esto sugiere que aunque se utilicen métricas cuantitativas, pueden perderse aspectos cualitativos importantes en la generación de lenguaje natural.  Asimismo, el creciente enfoque en el aprendizaje no supervisado ha impulsado una tendencia hacia enfoques que pueden considerar contextos más amplios al evaluar modelos, más allá de las comparaciones estrictas de texto. Esto lleva a cuestionar si las métricas tradicionales son suficientes para capturar la complejidad del lenguaje humano y la efectividad del lenguaje generado (NPL.pdf, Página 22).  En resumen, aunque las métricas tradicionales tienen su utilidad, su enfoque limitado puede no reflejar la efectividad real de la generación de lenguaje. Sería beneficioso explorar métricas que tengan en cuenta aspectos semánticos y contextuales, así como métodos que puedan captar la diversidad y las sutilezas del lenguaje. Esto podría facilitar una evaluación más holística y precisa.",3148,392,3540
4.540119171142578,¿Qué desafíos técnicos y éticos se deben considerar al implementar PLN en sistemas de moderación de contenido en redes sociales?,"El contexto proporcionado no menciona directamente los desafíos técnicos y éticos específicos que deben considerarse al implementar PLN en sistemas de moderación de contenido en redes sociales. Sin embargo, se puede inferir que, en un sistema de moderación, es fundamental considerar problemas como:  1. **Sesgos**: Los algoritmos de PLN pueden heredar sesgos presentes en los datos de entrenamiento, lo que podría llevar a decisiones injustas o errores en la moderación de contenido, como la censura indebida de publicaciones o la falla en la identificación de contenido inapropiado.  2. **Confusión semántica**: Representaciones incorrectas o mal entendidas de la intención detrás de un texto pueden generar malinterpretaciones.  3. **Dificultades con el lenguaje coloquial**: El lenguaje utilizado en redes sociales a menudo se caracteriza por jergas, abreviaturas y expresiones informales, lo que puede dificultar la efectividad de los modelos de PLN que fueron entrenados con un lenguaje más formal.  4. **Falta de contexto**: La comprensión del contexto es crucial, y los modelos de PLN deben ser capaces de tomar en cuenta el contexto de las conversaciones para evitar decisiones erróneas.  Considerar estos desafíos es esencial para la efectividad y la ética en la implementación de sistemas de PLN en la moderación de contenido.",1288,276,1564
5.502964735031128,¿Cómo abordarías el problema de la privacidad y protección de datos en el entrenamiento de modelos de PLN con información sensible?,"Abordar el problema de la privacidad y protección de datos en el entrenamiento de modelos de Procesamiento del Lenguaje Natural (PLN) con información sensible requiere varias estrategias clave:  1. **Anonymización de datos**: Es esencial procesar los datos para eliminar cualquier información identificable que pueda vincularse a individuos específicos. Esto incluye nombres, direcciones y otros detalles personales.  2. **Consentimiento informado**: Asegurarse de que los individuos cuyas datos se están usando han dado su consentimiento explícito para que sus datos sean utilizados en el entrenamiento de modelos, asegurando así que se respete su privacidad.  3. **Uso de datos sintéticos**: En lugar de usar datos reales, puede ser más seguro crear datos sintéticos que simulen la estructura y el contenido de los datos sensibles pero sin comprometer la privacidad de las personas. Esto permite entrenar modelos sin riesgo de exposición de datos reales.  4. **Implementación de técnicas de federated learning**: Esta estrategia permite entrenar modelos de PLN en múltiples dispositivos o servidores locales sin necesidad de centralizar los datos, de modo que la información sensible nunca salga de su localización original.  5. **Cumplimiento de normativas**: Es crucial seguir las directrices legales y éticas pertinentes, como el Reglamento General de Protección de Datos (GDPR) en la Unión Europea, que establece normas estrictas sobre cómo se deben manejar los datos personales.  6. **Evaluación continua del sesgo y la inclusión**: Durante el desarrollo de modelos, es importante evaluar continuamente si los datos utilizados perpetúan sesgos existentes y asegurarse de que el modelo resultante es inclusivo y justo.  Estos enfoques pueden ayudar a mitigar los riesgos asociados con el uso de datos sensibles en el entrenamiento de modelos de PLN, garantizando a la vez la eficacia de los mismos.",1973,376,2349
4.492736577987671,¿Qué papel crees que jugará la convergencia de hardware avanzado y algoritmos innovadores en el futuro del PLN?,"La convergencia de hardware avanzado y algoritmos innovadores en el futuro del procesamiento del lenguaje natural (PLN) será crucial para el desarrollo y la implementación de aplicaciones más sofisticadas y eficientes. Con el aumento en la capacidad de procesamiento y almacenamiento, los modelos de aprendizaje automático, incluidos aquellos basados en redes neuronales y transformers, podrán manejar conjuntos de datos más grandes y complejos, permitiendo un aprendizaje más profundo y un mejor entendimiento del lenguaje.  Además, el uso de arquitecturas de redes neuronales como los transformers, que están diseñados para trabajar de manera más eficaz con la secuencialidad y el paralelismo, mejorará notablemente la velocidad y la precisión de las tareas de PLN, desde la traducción automática hasta el análisis de sentimientos y el etiquetado semántico. Tal como se menciona en el documento, ""los transformers se componen de distintos bloques, donde se recibe un vector de datos de entrada, y se genera un vector de salida de el mismo tamaño"" (NPL.pdf, p. 256).  En resumen, la avanzada integración de hardware y algoritmos innovadores permitirá que el PLN no solo evolucione en su capacidad para entender y generar lenguaje humano, sino que también se aplique de manera más efectiva en una variedad de sectores, como Recursos Humanos y la medicina, donde el procesamiento eficiente de grandes volúmenes de información es esencial.",2302,285,2587
29.415415287017822,¿Cómo diseñarías un sistema de retroalimentación continua para mejorar el desempeño de un modelo de PLN desplegado en producción?,"Para diseñar un sistema de retroalimentación continua que mejore el desempeño de un modelo de procesamiento de lenguaje natural (PLN) desplegado en producción, se podrían seguir los siguientes pasos:  1. **Recolección de Datos de Retroalimentación**: Implementar un mecanismo para recolectar la retroalimentación del usuario sobre las salidas generadas por el modelo. Esto puede incluir encuestas, botones de satisfacción, o simplemente registros de interacciones y correcciones manuales por parte de usuarios.  2. **Análisis de Resultados**: Usar métricas cuantitativas para evaluar el desempeño del modelo en función de la retroalimentación recolectada. Este análisis puede basarse en métodos de evaluación que comparen el rendimiento del modelo con datos de referencia (página 20).   3. **Entrenamiento del Modelo**: Incorporar la nueva información obtenida a través de la retroalimentación en un proceso de reentrenamiento del modelo. Esto podría realizarse utilizando técnicas de aprendizaje supervisado sobre la información de los treebanks, como se menciona en el contexto (página 127), para crear un nuevo oráculo que ajuste las decisiones del modelo en función de errores pasados.  4. **Evaluación y Validación**: Realizar evaluaciones internas para validar que el modelo mejorado esté superando al anterior. Esto puede incluir pruebas en un conjunto de datos de validación que no se utilizó durante el entrenamiento original (página 205). También se puede utilizar evaluación extrínseca y/o intrínseca, evaluando el desempeño en tareas específicas de PLN (página 281).  5. **Despliegue Incremental**: Implementar el modelo actualizado de manera gradual, permitiendo comparaciones en tiempo real entre el modelo antiguo y el nuevo. Esto ayudará a asegurar que no se disminuyan las métricas de rendimiento en producción.  6. **Monitoreo Continuo**: Establecer un sistema de monitoreo continuo que observe el desempeño del modelo en la práctica, mezclando la recolección de datos de retroalimentación y la aplicación de nuevas métricas que puedan surgir a partir de tendencias en el uso del sistema.  Este sistema de retroalimentación continua no solo permitirá mejorar el modelo de PLN, sino que también facilitará adaptaciones a cambios en el lenguaje y en las expectativas de los usuarios.",3233,483,3716
14.74178957939148,"¿Qué estrategias utilizarías para asegurar la interpretabilidad de decisiones en modelos complejos de PLN en aplicaciones críticas, como la asistencia médica?","Para asegurar la interpretabilidad de decisiones en modelos complejos de Procesamiento de Lenguaje Natural (PLN) en aplicaciones críticas, como la asistencia médica, se pueden utilizar varias estrategias:  1. **Modelos Probabilistas**: Implementar métodos probabilistas en el análisis sintáctico es fundamental para calcular la probabilidad de cada posible interpretación y escoger la más probable. Esto permite tener una forma clara de entender cómo se llegó a una decisión específica, ya que se puede desglosar la probabilidad de cada interpretación. Un analizador sintáctico probabilista busca el árbol sintáctico más probable, lo que ayuda a hacer comprensibles las predicciones del modelo (NPL.pdf, Página 115).  2. **Transparencia en Algoritmos**: Utilizar algoritmos cuyas decisiones se puedan entender fácilmente, como los modelos de regresión o árboles de decisión, en vez de modelos más opacos como las redes neuronales profundas. Estos algoritmos permiten un razonamiento más transparente y accesible para los profesionales médicos.  3. **Evaluación Extrínseca e Intrínseca**: Realizar evaluaciones tanto extrínsecas, que analicen el rendimiento del modelo en un contexto real de aplicación (por ejemplo, en un sistema de diagnóstico médico), como intrínsecas, que evalúen directamente el modelo contra datos de referencia. Esto puede dar una indicación del funcionamiento y confiabilidad del modelo (NPL.pdf, Página 205).  4. **Visualización de Decisiones**: Implementar herramientas de visualización que muestren cómo el modelo llegó a una conclusión específica, destacando las características o inputs que más influyeron en la decisión. Esto puede ayudar a los profesionales a confiar más en las recomendaciones del modelo.  5. **Feedback de Expertos en el Dominio**: Integrar el feedback de expertos médicos en el proceso de desarrollo y validación del modelo puede ayudar a identificar y solucionar problemas de interpretación. La colaboración multidisciplinaria es clave para establecer confianza en las decisiones de los modelos.  6. **Explicaciones Locales**: Utilizar métodos de explicación local, como LIME o SHAP, que puedan proporcionar explicaciones de las decisiones del modelo para casos individuales puede ser útil para entender mejor por qué se hicieron ciertas recomendaciones en circunstancias específicas.  Estas estrategias pueden ayudar a crear modelos de PLN más interpretables y confiables en contextos críticos, como es el ámbito de la salud.",3767,497,4264
7.520889759063721,¿Cómo evaluarías la efectividad de un modelo de PLN en la generación de textos coherentes y contextualmente relevantes en entornos con alta variabilidad temática?,"Para evaluar la efectividad de un modelo de Procesamiento del Lenguaje Natural (PLN) en la generación de textos coherentes y contextualmente relevantes en entornos con alta variabilidad temática, se pueden considerar las siguientes estrategias:  1. **Uso de métricas de evaluación específicas**: Es crucial emplear métricas que permitan medir la calidad de los textos generados. Las métricas basadas en embeddings, como BERTScore, son útiles porque permiten evaluar las similitudes semánticas y ofrecen mayor flexibilidad en la comparación de traducciones o textos generados. Esto es especialmente relevante en entornos temáticos variados, donde la coherencia puede no depender estrictamente del orden de las palabras (NPL.pdf, Página 293).  2. **Entrenamiento y pruebas con datos representativos**: Es fundamental asegurarse de que el modelo sea entrenado y evaluado con conjuntos de datos que representen adecuadamente la variabilidad temática esperada. Esto ayudará a que el modelo aprenda a manejar distintas temáticas y estilos de escritura, lo que contribuirá a su capacidad para generar textos coherentes y relevantes.  3. **Análisis de sentimientos y contexto**: Implementar análisis de sentimientos puede proporcionar información sobre la adecuación de los textos generados en contextos específicos. Evaluar si los textos capturan el tono adecuado y las emociones esperadas en relación al tema es vital (NPL.pdf, Página 299).  4. **Revisión humana**: Aunque las métricas automatizadas son útiles, la revisión humana sigue siendo una herramienta valiosa para evaluar la coherencia y relevancia contextual. Expertos en el tema pueden ofrecer insights sobre la calidad de los textos generados y señalar áreas de mejora.  5. **Iteración y retroalimentación**: Implementar un sistema de retroalimentación continua en el que se recojan ejemplos de textos generados y se analicen para realizar ajustes en el modelo es esencial. Esto garantiza que el modelo se adapte y mejore en función de las necesidades específicas del entorno temático.  Al integrar estas estrategias, se puede lograr una evaluación más completa y efectiva de la capacidad del modelo de PLN para generar textos coherentes y relevantes en contextos de alta variabilidad temática.",3580,450,4030
7.943162441253662,¿Qué consideraciones metodológicas tomarías en cuenta para investigar la influencia de diferentes técnicas de preprocesamiento en el rendimiento final de un modelo de PLN?,"Para investigar la influencia de diferentes técnicas de preprocesamiento en el rendimiento final de un modelo de procesamiento de lenguaje natural (PLN), es importante considerar las siguientes metodologías:  1. **Definición de técnicas de preprocesamiento**: Es esencial identificar y describir las técnicas de preprocesamiento a investigar. Esto puede incluir la tokenización, la eliminación de palabras vacías, la lematización y el stemming, la normalización de texto, entre otros.  2. **Selección del corpus**: Elegir un corpus adecuado que represente el dominio del problema a resolver. La calidad y la relevancia del corpus pueden influir significativamente en los resultados obtenidos. Por ejemplo, el costo y dificultad de producir corpus anotados puede ser un factor limitante, llevando algunas investigaciones a utilizar datos sin anotación alguna (Página 22).  3. **Diseño experimental**: Es fundamental diseñar un experimento en el que se apliquen diferentes técnicas de preprocesamiento a la misma base de datos de texto. Se deben definir métricas de evaluación que permitan comparar el rendimiento de los modelos resultantes de cada una de las técnicas aplicadas.  4. **Implementación de modelos de PLN**: Usar un marco de referencia para la implementación de modelos de PLN. Por ejemplo, se pueden aplicar sistemas de traducción automática que utilizan diversas arquitecturas y técnicas de procesamiento (Página 281).  5. **Evaluación de modelos**: Evaluar el rendimiento de los modelos generados ante un conjunto de datos de prueba. Es importante realizar tanto evaluaciones intrínsecas como extrínsecas para obtener una visión completa del rendimiento del modelo y el impacto del preprocesamiento (Página 205).  6. **Análisis estadístico**: Aplicar análisis estadísticos para comparar los resultados obtenidos entre los diferentes enfoques de preprocesamiento, lo que permitirá validar la significancia de las diferencias observadas.  7. **Documentación y análisis de resultados**: Documentar todos los pasos del proceso de investigación y analizar los resultados en función de las métricas predefinidas, considerando no sólo el rendimiento del modelo, sino también la posible sobreajuste y la generalización.  Estos pasos permitirán investigar de manera sistemática la influencia de las distintas técnicas de preprocesamiento en el rendimiento de los modelos de PLN.",3540,473,4013
12.383354187011719,"¿Cómo abordarías el reto de crear modelos de PLN para idiomas con recursos limitados, garantizando una buena calidad en las aplicaciones?","Para abordar el reto de crear modelos de procesamiento del lenguaje natural (PLN) para idiomas con recursos limitados, se pueden considerar varias estrategias:  1. **Uso de Aprendizaje No Supervisado**: Dado que la producción de corpus anotados es costosa y puede ser un factor limitante, se puede recurrir a técnicas de aprendizaje no supervisado. Estas técnicas permiten construir aplicaciones lingüísticas sin necesidad de datos anotados, como se ha mencionado en el contexto, donde se comenzaron a desarrollar aplicaciones a partir de datos sin anotación alguna para tareas como la traducción automática y el modelado de temas (NPL.pdf, Página 22).  2. **Transferencia de Conocimiento**: Se puede aprovechar el conocimiento y los recursos de idiomas con más recursos desarrollando modelos de transferencia. Esto implica usar modelos previamente entrenados en idiomas con abundancia de datos y adaptar esos conocimientos para el idioma objetivo. Esto es útil, especialmente en sistemas de traducción automática.  3. **Generación de Recursos Anotados**: Se pueden utilizar técnicas de etiquetado automático apoyándose en algoritmos de aprendizaje supervisado y no supervisado para construir corpus anotados, como el etiquetado morfosintáctico y semántico (NPL.pdf, Página 22).  4. **Uso de Bibliotecas y Herramientas Adaptadas**: Herramientas como NLTK y spaCy pueden ser adaptadas para el idiomas con recursos limitados. Estas bibliotecas permiten realizar procesamiento del lenguaje natural con una facilidad considerable y pueden ser utilizadas para crear modelos aunque el corpus sea pequeño (NPL.pdf, Página 54).  5. **Evaluación Continua**: Implementar evaluaciones intrínsecas y extrínsecas para validar la calidad de los modelos desarrollados. Esto garantiza que, a pesar de contar con recursos limitados, los modelos cumplan con un estándar de calidad aceptable. Las evaluaciones extrínsecas implican analizar la mejora del rendimiento de un sistema de PLN al incorporar un modelo específico, mientras que las intrínsecas se basan en conjuntos de datos de referencia (NPL.pdf, Página 205).  Estas estrategias permiten optimizar el uso de recursos limitados y proporcionar soluciones efectivas en el ámbito del procesamiento del lenguaje natural para idiomas menos favorecidos.",2997,467,3464
9.991445302963257,"¿Qué impacto tendría la integración de sistemas multimodales (texto, imagen, audio) en la precisión y utilidad de aplicaciones basadas en PLN?","La integración de sistemas multimodales (texto, imagen, audio) en aplicaciones basadas en PLN podría aumentar significativamente tanto la precisión como la utilidad de estas aplicaciones. Este enfoque permitiría a los sistemas procesar y entender información de diversas fuentes simultáneamente, lo cual es especialmente importante en la interpretación de datos complejos y contextos variados.  Por ejemplo, al combinar el reconocimiento de voz (ASR) con procesamiento de texto y análisis de imágenes, se podría mejorar el contexto de las interacciones del usuario, llevando a resultados más precisos. La capacidad de tener información visual y de audio en conjunto permitiría que los modelos de lenguaje tengan un contexto más rico para interpretar intenciones y significados, especialmente en situaciones donde el lenguaje verbal pueda ser ambiguo (como se menciona sobre la ambigüedad fonética en el reconocimiento de voz) (archivo: NPL.pdf, página 200).  Además, en el procesamiento del lenguaje natural, el uso de contextos visuales y auditivos podría ayudar a desambiguar significados y proporcionar un rendimiento mejorado en tareas como la traducción automática y el análisis de sentimientos. La utilización de múltiples modalidades puede enriquecer el modelo de lenguaje, incrementando su capacidad para manejar diversas situaciones de comunicación y mejorando la interacción del usuario con la tecnología, lo que se refleja en una mayor satisfacción y usabilidad de las aplicaciones. Las capacidades de generación y resonancia de significados en diferentes formatos (como texto a audio y viceversa) también son un aspecto fundamental que podría beneficiarse de estos enfoques multimodales (archivo: NPL.pdf, página 308 y 281).  Por tanto, la integración de sistemas multimodales puede transformar la forma en que las aplicaciones de PLN reciben, interpretan y responden a la información, llevando a mejoras notables en la efectividad y aplicabilidad en diferentes sectores, como recursos humanos y atención médica, donde los análisis pueden ser más profundos y contextualizados (archivo: NPL.pdf, página 11).",3249,407,3656
11.163799285888672,¿Cómo propondrías medir el impacto real de un modelo de PLN en la mejora de procesos educativos y en la atención a estudiantes?,"Para medir el impacto real de un modelo de Procesamiento del Lenguaje Natural (PLN) en la mejora de procesos educativos y en la atención a estudiantes, se podrían considerar varias métricas y enfoques de evaluación:  1. **Evaluación extrínseca**: Este tipo de evaluación se centra en cómo el modelo de PLN mejora el rendimiento de aplicaciones educativas específicas. Por ejemplo, si un sistema de PLN se utiliza para análisis de textos o para la asistencia a estudiantes, se podría evaluar si la implementación de dicho sistema mejora la retención de información o los resultados académicos de los estudiantes. Esta forma de evaluación se describe en la sección sobre evaluación de modelos, donde se menciona que ""se podría evaluar si el rendimiento mejora al utilizar dicho LM"" (NPL.pdf, página 205).  2. **Evaluación intrínseca**: Además de evaluar el rendimiento en aplicaciones específicas, sería útil realizar evaluaciones intrínsecas, comparando los resultados del modelo de PLN con un conjunto de datos de referencia. Esto permitiría conocer cómo el modelo se desempeña en tareas específicas dentro del contexto educativo (como análisis de respuestas o comprensión de textos) y podría proporcionar datos sobre las probabilidades de las secuencias correctas en contextos académicos, como se señala en el mismo documento (NPL.pdf, página 205).  3. **Recopilación de datos cualitativos y cuantitativos**: Se podría realizar un seguimiento y análisis del feedback de estudiantes y docentes, así como un análisis de la cantidad y calidad de las interacciones que los estudiantes tienen con las herramientas impulsadas por PLN. Esto ayudaría a proporcionar un contexto más rico sobre cómo el modelo impacta la experiencia de aprendizaje.  4. **Métricas de desempeño académico**: Evaluar cambios en las métricas de desempeño académico, como las calificaciones, la tasa de aprobación, y el tiempo dedicado a las tareas, puede proporcionar información sobre la efectividad del modelo de PLN. Esta información puede ser complementada con datos sobre la satisfacción del estudiante.  5. **Estudios de casos y análisis longitudinales**: Realizar estudios de caso específicos en entornos educativos donde se implemente el modelo de PLN, y realizar un seguimiento a largo plazo de su implementación, puede ofrecer valiosos insights sobre su impacto real a medida que se adapta a diferentes contextos y necesidades de los estudiantes.  Implementando estas estrategias, se podría obtener una visión más clara del impacto que los modelos de PLN tienen sobre los procesos educativos y la atención a estudiantes, facilitando mejores decisiones informadas en el desarrollo de futuras aplicaciones en el ámbito educativo.",2203,527,2730
7.684044599533081,¿Qué desafíos específicos enfrentarías al aplicar modelos de PLN en la traducción de textos con estructuras gramaticales muy distintas y cómo los solucionarías?,"Al aplicar modelos de Procesamiento del Lenguaje Natural (PLN) en la traducción de textos con estructuras gramaticales muy distintas, enfrentarías varios desafíos específicos. Uno de los principales problemas es que las diferencias en la estructura de las frases, como el orden de los verbos y los objetos directos, pueden complicar la traducción precisa. Esto implica que no basta con traducir palabras individuales, ya que se debe considerar el contexto y la estructura de toda la oración. Como se menciona en el documento, ""a pesar de que existen elementos universales del lenguaje comunes a todas las lenguas, existen también diferencias entre ellas"" (NPL.pdf, página 283).   Para solucionar estos desafíos, se pueden implementar varias estrategias:  1. **Arquitecturas específicas**: Utilizar arquitecturas de aprendizaje profundo como el modelo encoder-decoder, que puede captar mejor el contexto de las secuencias y las relaciones entre las palabras en diferentes estructuras gramaticales (NPL.pdf, página 284). Estos modelos están diseñados para convertir una secuencia de entrada en una representación contextual, que a su vez se utiliza para generar la secuencia de salida.  2. **Técnicas de aprendizaje no supervisado**: Dado que el coste y la dificultad de producir corpus anotados pueden ser limitantes, las técnicas de aprendizaje no supervisado pueden ser útiles para construir aplicaciones lingüísticas que no dependan de datos anotados (NPL.pdf, página 22). Esto permitiría explorar patrones y estructuras en datos de texto sin la necesidad de una amplia anotación, lo que facilita la traducción de lenguas con estructuras muy diferentes.  3. **Uso de métricas flexibles**: Implementar métricas que comparen no solo cadenas de caracteres, sino que evalúen traducciones a nivel de embeddings. Esto permite más flexibilidad al evaluar la precisión de las traducciones y puede incluir sinónimos o estructuras alternativas que sean válidas en la lengua de destino (NPL.pdf, página 293).  4. **Capacitación continua del modelo**: Es crucial entrenar los modelos de PLN con un conjunto de datos lo más diverso y representativo posible, que incluya múltiples ejemplos de traducciones entre frases con distintas gramáticas. Esto ayudará a que el modelo aprenda a manejar variaciones gramaticales y mantenga la coherencia en su desempeño en diferentes lenguas.  Estas estrategias pueden ayudar a mitigar los desafíos asociados con la traducción automática entre lenguas con diferencias estructurales significativas.",3280,515,3795
10.009964227676392,¿Cómo evaluarías la capacidad de un modelo de PLN para captar y procesar la evolución del lenguaje en redes sociales y medios digitales?,"Para evaluar la capacidad de un modelo de Procesamiento del Lenguaje Natural (PLN) en captar y procesar la evolución del lenguaje en redes sociales y medios digitales, se pueden considerar varios aspectos:  1. **Análisis de Sentimientos**: La capacidad del modelo para clasificar y analizar el sentimiento de las opiniones expresadas en textos de redes sociales, determinando si son positivas, negativas o neutras. Esto permite entender las tendencias del lenguaje y las reacciones de los usuarios a eventos o productos. Según el documento, se menciona que “se pueden analizar el sentimiento de los usuarios hacia una marca o producto...” utilizando técnicas de PLN (Archivo: NPL.pdf, Página 10).  2. **Adaptabilidad a Nuevos Términos y Frases**: Evaluar hasta qué punto el modelo puede incorporar y adaptarse a nuevos términos, jergas y frases que emergen en el contexto digital. Esto incluye la capacidad de entender siglas, emojis y otros elementos comunicativos típicos de las redes sociales.  3. **Capacidad de Recuperación de Información**: La habilidad del modelo para extraer, resumir y responder preguntas basadas en grandes volúmenes de información textual. Esto incluye la eficacia de sistemas de ""Question Answering"" que buscan responder consultas de los usuarios a partir de colecciones de documentos (Archivo: NPL.pdf, Página 281).  4. **Uso de Datos No Anotados**: La evolución del PLN hacia el uso de técnicas de aprendizaje no supervisado para abordar problemas complejos en datos no anotados es otro indicador. Este enfoque es crucial para trabajar con la enorme cantidad de datos textuales generados en redes sociales, donde la anotación manual es poco práctica (Archivo: NPL.pdf, Página 22).  5. **Evaluación Cuantitativa y Comparativa**: Es fundamental implementar métricas cuantitativas para evaluar el rendimiento del modelo en comparación con investigaciones previas, asegurando que se mide adecuadamente la eficacia en la evolución y captura de la dinámica del lenguaje (Archivo: NPL.pdf, Página 20).  En resumen, la evaluación de un modelo de PLN en este contexto debe ser multifacética, considerando su adaptabilidad, la eficacia en análisis de sentimientos, la recuperación de información, el uso de datos no anotados y un enfoque riguroso en la evaluación del rendimiento.",3046,481,3527
10.757316589355469,¿Qué innovaciones crees que son necesarias para que los modelos de PLN puedan comprender mejor contextos y matices culturales en aplicaciones globales?,"Para que los modelos de Procesamiento del Lenguaje Natural (PLN) puedan comprender mejor contextos y matices culturales en aplicaciones globales, es fundamental implementar innovaciones que aborden varios aspectos:  1. **Corpus Diversificados y Anotados Culturalmente**: La creación de corpus más amplios y diversos que incluyan variaciones culturales y dialectales permitirá a los modelos aprender de una gama más rica de expresiones y contextos. Esto ayudaría a mitigar sesgos y a representar adecuadamente diferentes voces y perspectivas culturales. La dificultad de producir corpus anotados se identificó como un factor limitante (página 22).  2. **Mejora en el Aprendizaje No Supervisado**: Dado que las técnicas de aprendizaje no supervisado están ganando tracción en la lingüística computacional, estas podrían beneficiar la comprensión de contextos culturales al permitir que los modelos aprendan patrones y relaciones sin necesitar grandes cantidades de datos anotados. Esto es crucial para adaptar los modelos a contextos locales específicos (página 22).  3. **Integración de Información Semántica y Cultural**: La implementación de análisis semántico integrado podría mejorar la comprensión del significado dentro de contextos específicos. Añadir consideraciones culturales en la etapa de análisis ayudaría a crear representaciones más precisas que tomen en cuenta las sutilezas del lenguaje y su uso en contextos culturales variados (página 150).  4. **Desarrollo de Modelos de Lenguaje Contextuales**: Utilizar arquitecturas modernas, como transformers, que incorporen mecanismos de atención puede permitir que los modelos mantengan en cuenta información contextual importante y, por ende, reconocer matices culturales en los textos (página 256).  5. **Personalización y Adaptación del Modelo**: Capacitar a los modelos para que se adapten y personalicen en función del contexto cultural del usuario puede mejorar significativamente su eficacia en aplicaciones globales. Esto incluiría ajustes en la forma en que se interpretan los datos y se responden a ellos según el contexto cultural del público objetivo.  6. **Colaboración Interdisciplinaria**: La integración de expertos en diversas áreas culturales, lingüistas y especialistas en ética en el desarrollo de modelos de PLN puede enriquecer el entendimiento de los matices culturales y garantizar que los modelos sean más inclusivos y sensibles a contextos específicos.  La combinación de estas innovaciones sería clave para que los sistemas de PLN puedan abordar de manera efectiva los desafíos asociados con la comprensión cultural en un mundo cada vez más globalizado.",3168,519,3687
8.117690563201904,¿Cómo diseñarías un sistema de evaluación que integre tanto métricas cuantitativas como juicios cualitativos para valorar la calidad de la generación automática de lenguaje?,"Para diseñar un sistema de evaluación que integre métricas cuantitativas y juicios cualitativos en la valoración de la calidad de la generación automática de lenguaje, se pueden seguir los siguientes pasos:  1. **Métricas Cuantitativas**: Implementar métricas como la tasa de error por palabra (Word Error Rate, WER) o perplejidad (Perplexity, PP). Estas métricas permiten medir de manera objetiva cómo se compara el texto generado con un conjunto de referencia. Una métrica habitual para evaluar modelos de lenguaje es la perplejidad, donde ""cuanto mayor probabilidad tenga la secuencia, menor será el valor de PP"" (Página 206, ""Procesamiento del Lenguaje Natural"").   2. **Juicios Cualitativos**: Complementar las métricas cuantitativas con evaluaciones manuales que consideren aspectos como la fluidez, coherencia y relevancia del texto generado. Esto puede implicar la creación de un panel de expertos o usuarios que evaluarán ejemplos de generación automática y proporcionarán retroalimentación sobre aspectos cualitativos.  3. **Evaluación Comparativa**: Utilizar un marco analítico que permita la comparación de métricas cuantitativas junto con los juicios cualitativos. Por ejemplo, se pueden clasificar los resultados de las métricas cuantitativas en rangos y relacionarlos con las calificaciones cualitativas dadas por los evaluadores para identificar patrones y discrepancias.  4. **Iteración y Ajuste**: Incorporar resultados de ambas evaluaciones para ajustar y mejorar el modelo de generación de lenguaje. Es fundamental que el sistema de evaluación esté diseñado para aprender y evolucionar en base a la retroalimentación recibida tanto de las métricas como de los juicios cualitativos.  5. **Documentación y Transparencia**: Asegurarse de que el proceso de evaluación, así como las métricas y criterios de juicio cualitativo, estén claramente documentados para facilitar la reproducibilidad y la transparencia en la evaluación de la calidad de la generación automática de lenguaje.  Este enfoque integrado permite obtener una valoración más completa y robusta de la calidad del lenguaje generado, abarcando tanto aspectos medibles como subjetivos.",3542,457,3999
8.581058979034424,¿Qué aspectos considerarías esenciales para la sostenibilidad y actualización a largo plazo de modelos de PLN en entornos de rápida evolución tecnológica?,"Para asegurar la sostenibilidad y actualización a largo plazo de los modelos de Procesamiento del Lenguaje Natural (PLN) en entornos de rápida evolución tecnológica, se deberían considerar los siguientes aspectos esenciales:  1. **Flexibilidad de los Modelos**: Los modelos deben ser diseñados para adaptarse a nuevas tecnologías y datos sin requerir una reestructuración completa. Esto implica la capacidad de integrar nuevas técnicas y formularios de datos.  2. **Uso de Aprendizaje No Supervisado**: Como se mencionó, el costo y la dificultad de producir corpus anotados son factores limitantes para los enfoques supervisados. Promover técnicas de aprendizaje no supervisado permitirá construir aplicaciones lingüísticas a partir de datos sin anotación, facilitando la actualización continua (NPL.pdf, p. 22).  3. **Adopción de Nuevas Arquitecturas**: Con el surgimiento de arquitecturas avanzadas como los transformers, es crucial adoptar y experimentar con nuevos modelos que puedan manejar mejor las limitaciones de las redes neuronales recurrentes (NPL.pdf, p. 256). Esto incluye el uso de capas de self-attention para mejorar la captura de información a lo largo del contexto.  4. **Evaluación Continua y Ajustes**: Implementar metodologías de evaluación tanto intrínsecas como extrínsecas garantizará que los modelos se mantengan relevantes. Se deben establecer métricas para evaluar el rendimiento de los modelos en tareas específicas de PLN, adaptadas a cambios en los datos o en el contexto de aplicación (NPL.pdf, p. 205).  5. **Interacción con la Comunidad**: Un enfoque colaborativo que incluya la interacción continua entre lingüistas computacionales, ingenieros y la comunidad estadística puede impulsar innovaciones en el campo del PLN, manteniendo así la competitividad y la eficacia de los modelos (NPL.pdf, p. 22).  6. **Atención a la Ética y Sesgos**: Considerar elementos éticos en el desarrollo de modelos de PLN es fundamental, especialmente en la creación de sistemas como la traducción automática y el análisis de sentimientos, para evitar perpetuar sesgos existentes en los datos (NPL.pdf, p. 281).  7. **Capacidad de Escalabilidad**: Los modelos deben ser capaces de escalar con el aumento de datos y la complejidad del lenguaje, lo que a menudo implica una mejor infraestructura tecnológica y el uso eficiente de recursos computacionales.  Al considerar estos aspectos, los modelos de PLN estarán mejor equipados para adaptarse y prosperar en un entorno de rápida evolución tecnológica.",3297,531,3828
